"aq" = (/obj/structure/wreck/trash/engine,/turf/open/indestructible/ground/outside/desert,/area/f13/wasteland)
"aF" = (/obj/structure/wreck/trash/one_barrel,/turf/open/indestructible/ground/outside/desert,/area/f13/wasteland)
"aH" = (/obj/effect/overlay/desert_side{dir = 1},/obj/effect/spawner/lootdrop/keg,/turf/open/floor/wood_common,/area/f13/building/khanfort)
"aR" = (/obj/structure/destructible/tribal_torch/wall/lit{dir = 1; pixel_y = 17},/turf/open/indestructible/ground/inside/mountain,/area/f13/tunnel/khanfort)
"bA" = (/obj/structure/wreck/trash/one_tire,/turf/open/indestructible/ground/outside/desert,/area/f13/wasteland)
"bF" = (/obj/structure/obstacle/barbedwire{dir = 4},/turf/open/indestructible/ground/outside/desert,/area/f13/wasteland)
"bQ" = (/obj/structure/destructible/tribal_torch/wall/lit{dir = 8},/turf/open/indestructible/ground/inside/mountain,/area/f13/tunnel/khanfort)
"cA" = (/obj/structure/reagent_dispensers/watertank,/turf/open/indestructible/ground/inside/mountain,/area/f13/tunnel/khanfort)
"cB" = (/obj/structure/fence{dir = 4},/turf/open/indestructible/ground/outside/desert,/area/f13/wasteland)
"cD" = (/turf/open/floor/wood_common/wood_common_dark,/area/f13/building/khanfort)
"de" = (/obj/structure/obstacle/barbedwire/end{dir = 4},/turf/open/indestructible/ground/outside/desert,/area/f13/wasteland)
"do" = (/obj/structure/destructible/tribal_torch/lit,/turf/open/indestructible/ground/outside/desert,/area/f13/wasteland/khans)
"dD" = (/obj/machinery/autolathe/ammobench,/turf/open/indestructible/ground/inside/mountain,/area/f13/tunnel/khanfort)
"ef" = (/obj/structure/simple_door/metal/fence{dir = 4},/turf/open/indestructible/ground/outside/desert,/area/f13/wasteland/khans)
"en" = (/obj/machinery/chem_lab/drug_lab,/turf/open/indestructible/ground/inside/mountain,/area/f13/tunnel/khanfort)
"eO" = (/obj/structure/destructible/tribal_torch/wall/lit{dir = 4},/turf/open/indestructible/ground/inside/mountain,/area/f13/tunnel/khanfort)
"fi" = (/obj/structure/rack/shelf_metal,/obj/item/clothing/head/helmet/f13/khan/bandana,/obj/effect/decal/cleanable/dirt,/obj/item/storage/bag/money/small/khan,/obj/item/clothing/shoes/f13/military/khan_pelt,/obj/effect/spawner/lootdrop/f13/weapon/gun/ammo/tier1,/obj/effect/spawner/lootdrop/f13/weapon/gun/ammo/tier1,/obj/effect/spawner/lootdrop/f13/weapon/gun/ammo/tier1,/turf/open/floor/wood_common/wood_common_light,/area/f13/building/khanfort)
"fx" = (/obj/item/reagent_containers/glass/bottle/blackpowder,/obj/item/reagent_containers/glass/bottle/blackpowder,/obj/structure/rack/shelf_metal,/turf/open/indestructible/ground/inside/mountain,/area/f13/tunnel/khanfort)
"fy" = (/obj/structure/closet/fridge/standard,/turf/open/indestructible/ground/inside/mountain,/area/f13/tunnel/khanfort)
"fJ" = (/obj/effect/spawner/structure/window/hollow,/obj/effect/spawner/structure/window/hollow,/turf/open/floor/wood_common/wood_common_dark,/area/f13/building/khanfort)
"gd" = (/obj/structure/table,/obj/machinery/reagentgrinder,/turf/open/indestructible/ground/inside/mountain,/area/f13/tunnel/khanfort)
"gx" = (/obj/structure/fence,/turf/open/indestructible/ground/outside/desert,/area/f13/wasteland)
"hc" = (/obj/structure/chair/pew/left{dir = 8},/turf/open/indestructible/ground/inside/mountain,/area/f13/tunnel/khanfort)
"hg" = (/obj/structure/table/optable,/turf/open/indestructible/ground/inside/mountain,/area/f13/tunnel/khanfort)
"hC" = (/obj/structure/table,/obj/item/storage/briefcase/medical,/obj/item/storage/survivalkit/medical,/obj/item/storage/survivalkit/medical,/obj/item/storage/survivalkit/medical/tribal,/turf/open/indestructible/ground/inside/mountain,/area/f13/tunnel/khanfort)
"hN" = (/obj/structure/destructible/tribal_torch/wall/lit{dir = 1; pixel_y = 28},/obj/structure/wreck/trash/one_barrel,/turf/open/indestructible/ground/outside/desert,/area/f13/wasteland)
"it" = (/obj/machinery/smartfridge/bottlerack/drug_storage,/obj/effect/spawner/lootdrop/druggie_pill,/turf/open/indestructible/ground/inside/mountain,/area/f13/tunnel/khanfort)
"iy" = (/obj/structure/wreck/trash/brokenvendor,/turf/open/indestructible/ground/outside/desert,/area/f13/wasteland)
"iC" = (/obj/structure/billboard/redrocket2,/turf/open/indestructible/ground/outside/desert,/area/f13/wasteland)
"iJ" = (/obj/structure/car/rubbish4,/turf/open/indestructible/ground/outside/desert,/area/f13/wasteland)
"jm" = (/obj/structure/chair/pew/left{dir = 4},/turf/open/indestructible/ground/inside/mountain,/area/f13/tunnel/khanfort)
"ku" = (/obj/structure/simple_door/wood,/turf/open/floor/wood_common/wood_common_dark,/area/f13/building/khanfort)
"lf" = (/obj/structure/fence/corner,/turf/open/indestructible/ground/outside/desert,/area/f13/wasteland)
"lk" = (/obj/structure/table/reinforced,/obj/item/storage/box/drinkingglasses,/obj/item/storage/box/drinkingglasses,/obj/item/storage/box/drinkingglasses,/obj/effect/overlay/desert_side{dir = 1},/obj/effect/overlay/desert_side{dir = 4},/turf/open/floor/wood_common,/area/f13/building/khanfort)
"lm" = (/obj/structure/table/wood/bar,/turf/open/indestructible/ground/inside/mountain,/area/f13/tunnel/khanfort)
"lv" = (/turf/open/indestructible/ground/inside/mountain,/area/f13/tunnel/khanfort)
"lx" = (/turf/closed/wall/mineral/wood/nonmetal,/area/f13/tunnel/khanfort)
"lS" = (/obj/structure/fence{dir = 1},/turf/open/indestructible/ground/outside/desert,/area/f13/wasteland/khans)
"md" = (/obj/structure/bonfire/prelit,/turf/open/indestructible/ground/outside/desert,/area/f13/wasteland)
"mJ" = (/turf/open/floor/wood_common,/area/f13/building/khanfort)
"nE" = (/obj/structure/table/wood/bar,/turf/open/floor/wood_common,/area/f13/building/khanfort)
"nL" = (/obj/structure/chair/stool/f13stool,/turf/open/floor/wood_common,/area/f13/building/khanfort)
"nR" = (/obj/structure/rack/shelf_metal,/obj/item/clothing/under/f13/khan/shorts,/obj/item/storage/survivalkit/khan,/obj/effect/spawner/lootdrop/f13/weapon/gun/ballistic/low,/turf/open/floor/wood_common/wood_common_light,/area/f13/building/khanfort)
"nW" = (/turf/closed/wall/mineral/brick,/area/f13/building/khanfort)
"oj" = (/obj/structure/destructible/tribal_torch/wall/lit{dir = 1; pixel_y = 28},/turf/open/indestructible/ground/outside/desert,/area/f13/wasteland)
"oE" = (/obj/structure/destructible/tribal_torch/wall/lit,/obj/structure/closet/crate/bin/trashbin,/turf/open/indestructible/ground/inside/mountain,/area/f13/tunnel/khanfort)
"pF" = (/obj/effect/turf_decal/huge/khan,/obj/machinery/chem_master,/turf/open/indestructible/ground/inside/mountain,/area/f13/tunnel/khanfort)
"pJ" = (/obj/structure/table,/obj/item/storage/bag/tray,/obj/item/reagent_containers/glass/bucket,/obj/item/candle,/turf/open/indestructible/ground/inside/mountain,/area/f13/tunnel/khanfort)
"pX" = (/obj/effect/decal/cleanable/dirt,/obj/structure/destructible/tribal_torch/lit,/turf/open/floor/wood_common/wood_common_dark,/area/f13/building/khanfort)
"qg" = (/obj/structure/obstacle/barbedwire/end,/turf/open/indestructible/ground/outside/desert,/area/f13/wasteland)
"ql" = (/obj/structure/chair/stool/bar/bronze,/obj/effect/overlay/desert_side,/obj/effect/overlay/desert_side{dir = 4},/turf/open/floor/wood_common,/area/f13/building/khanfort)
"qs" = (/turf/open/indestructible/ground/outside/gravel/path_desert{dir = 10},/area/f13/wasteland)
"qT" = (/obj/structure/table,/obj/item/storage/belt/medical/primitive,/obj/item/storage/survivalkit/medical/follower,/obj/item/stack/medical/gauze,/obj/item/stack/medical/gauze,/obj/item/stack/medical/gauze,/obj/item/stack/medical/gauze,/obj/item/storage/survivalkit/khan,/turf/open/indestructible/ground/inside/mountain,/area/f13/tunnel/khanfort)
"rb" = (/obj/structure/fence/corner,/turf/open/indestructible/ground/outside/desert,/area/f13/wasteland/khans)
"rh" = (/obj/structure/rack/shelf_metal,/obj/item/clothing/suit/armor/khan_jacket,/obj/item/clothing/under/f13/khan/shorts,/obj/effect/spawner/lootdrop/f13/weapon/gun/ballistic/hobo,/turf/open/floor/wood_common/wood_common_light,/area/f13/building/khanfort)
"rG" = (/obj/effect/decal/cleanable/dirt,/turf/closed/wall/mineral/wood/nonmetal,/area/f13/building/khanfort)
"rX" = (/obj/structure/chair/comfy/brown{dir = 1},/turf/open/indestructible/ground/inside/mountain,/area/f13/tunnel/khanfort)
"rZ" = (/obj/item/trash/tray,/turf/open/indestructible/ground/outside/desert,/area/f13/wasteland)
"sb" = (/obj/structure/destructible/tribal_torch/lit,/turf/open/indestructible/ground/outside/desert,/area/f13/wasteland)
"sv" = (/obj/structure/closet/crate/bin/trashbin,/turf/open/indestructible/ground/inside/mountain,/area/f13/tunnel/khanfort)
"sU" = (/obj/structure/car/rubbish3,/turf/open/indestructible/ground/outside/desert,/area/f13/wasteland)
"sV" = (/obj/machinery/workbench,/turf/open/indestructible/ground/inside/mountain,/area/f13/tunnel/khanfort)
"sX" = (/obj/structure/chair/sofa/corp/left,/turf/open/indestructible/ground/outside/desert,/area/f13/wasteland)
"sZ" = (/obj/structure/chair/pew/right{dir = 4},/turf/open/indestructible/ground/inside/mountain,/area/f13/tunnel/khanfort)
"tz" = (/obj/item/reagent_containers/glass/bucket,/turf/open/indestructible/ground/inside/dirt,/area/f13/building/khanfort)
"tF" = (/obj/structure/fence{dir = 1},/turf/open/indestructible/ground/outside/desert,/area/f13/wasteland)
"tO" = (/turf/open/indestructible/ground/outside/gravel/path_desert{dir = 5},/area/f13/wasteland)
"uB" = (/obj/structure/table/wood/bar,/obj/machinery/chem_dispenser/drinks/beer,/turf/open/indestructible/ground/inside/mountain,/area/f13/tunnel/khanfort)
"uE" = (/obj/structure/closet/fridge/meat,/turf/open/indestructible/ground/inside/mountain,/area/f13/tunnel/khanfort)
"uQ" = (/obj/effect/decal/cleanable/dirt,/obj/structure/chair/comfy/plywood{dir = 4},/turf/open/floor/wood_common/wood_common_dark,/area/f13/building/khanfort)
"uZ" = (/obj/structure/rack,/obj/item/stack/sheet/metal/twenty,/obj/item/stack/sheet/metal/twenty,/obj/item/stack/sheet/glass/ten,/obj/item/stack/sheet/glass/ten,/obj/item/stack/ore/blackpowder/twenty,/turf/open/indestructible/ground/inside/mountain,/area/f13/tunnel/khanfort)
"vz" = (/obj/structure/table/wood/bar,/obj/machinery/chem_dispenser/drinks,/turf/open/indestructible/ground/inside/mountain,/area/f13/tunnel/khanfort)
"vV" = (/obj/structure/chair/stool/bar/bronze,/obj/effect/overlay/desert_side,/obj/effect/overlay/desert_side{dir = 8},/turf/open/floor/wood_common,/area/f13/building/khanfort)
"wc" = (/obj/effect/decal/cleanable/dirt,/turf/open/floor/wood_common/wood_common_dark,/area/f13/building/khanfort)
"wl" = (/obj/structure/destructible/tribal_torch/wall/lit,/turf/open/indestructible/ground/inside/mountain,/area/f13/tunnel/khanfort)
"xs" = (/obj/structure/fence/corner{dir = 1},/turf/open/indestructible/ground/outside/desert,/area/f13/wasteland)
"xB" = (/turf/open/indestructible/ground/outside/gravel/path_desert{dir = 1},/area/f13/wasteland)
"xC" = (/obj/structure/rack/shelf_metal,/obj/item/clothing/head/helmet/f13/khan,/obj/item/clothing/suit/armor/medium/vest/breastplate/khan,/obj/effect/spawner/lootdrop/f13/weapon/gun/ballistic/low,/turf/open/floor/wood_common/wood_common_light,/area/f13/building/khanfort)
"yz" = (/obj/structure/table/wood/bar,/obj/item/storage/box/drinkingglasses,/turf/open/indestructible/ground/inside/mountain,/area/f13/tunnel/khanfort)
"yE" = (/obj/structure/rack/shelf_metal,/obj/item/clothing/suit/toggle/labcoat/khan_jacket/armored,/obj/item/clothing/under/f13/khan/booty,/obj/effect/spawner/lootdrop/f13/weapon/gun/ammo/tier1,/obj/effect/spawner/lootdrop/f13/weapon/gun/ammo/tier1,/obj/effect/spawner/lootdrop/f13/weapon/gun/ammo/tier1,/turf/open/floor/wood_common/wood_common_light,/area/f13/building/khanfort)
"yI" = (/turf/closed/mineral/strong/wasteland,/area/f13/wasteland)
"yR" = (/turf/open/indestructible/ground/outside/gravel/path_desert/end{dir = 4},/area/f13/wasteland)
"za" = (/turf/open/indestructible/ground/inside/dirt,/area/f13/building/khanfort)
"zm" = (/obj/structure/simple_door/repaired,/turf/open/indestructible/ground/inside/mountain,/area/f13/tunnel/khanfort)
"zA" = (/obj/structure/bed/mattress,/turf/open/floor/wood_common/wood_common_dark,/area/f13/building/khanfort)
"zT" = (/obj/structure/destructible/tribal_torch/wall/lit{dir = 8},/turf/open/indestructible/ground/outside/desert,/area/f13/wasteland)
"zY" = (/obj/effect/overlay/desert/sonora/edge{dir = 4},/obj/effect/overlay/desert/sonora/edge/corner{dir = 1},/obj/effect/overlay/desert/sonora/edge/corner{dir = 4},/turf/open/indestructible/ground/outside/gravel,/area/f13/wasteland)
"Ad" = (/obj/structure/wreck/trash/secway,/turf/open/indestructible/ground/outside/desert,/area/f13/wasteland)
"Al" = (/obj/structure/chair/pew/right{dir = 4},/obj/effect/decal/cleanable/dirt,/turf/open/indestructible/ground/inside/mountain,/area/f13/tunnel/khanfort)
"AS" = (/obj/structure/rack/shelf_metal,/obj/item/clothing/suit/toggle/labcoat/khan_jacket/armored,/obj/item/clothing/under/f13/khan/shorts,/obj/effect/spawner/lootdrop/f13/weapon/gun/ballistic/lowmid,/turf/open/floor/wood_common/wood_common_light,/area/f13/building/khanfort)
"Bq" = (/obj/effect/spawner/structure/window/hollow,/turf/open/floor/wood_common/wood_common_dark,/area/f13/building/khanfort)
"Bs" = (/obj/machinery/door/unpowered/securedoor/khandoor,/turf/open/floor/wood_common/wood_common_dark,/area/f13/building/khanfort)
"BD" = (/obj/structure/wreck/trash/four_barrels,/turf/open/indestructible/ground/outside/desert,/area/f13/wasteland)
"BM" = (/obj/structure/table/reinforced,/obj/machinery/chem_dispenser/drinks/beer,/obj/effect/overlay/desert_side{dir = 1},/turf/open/floor/wood_common,/area/f13/building/khanfort)
"BU" = (/obj/structure/rack/shelf_metal,/obj/item/clothing/shoes/f13/military/khan,/obj/item/clothing/under/f13/khan/booty,/obj/item/clothing/suit/armor/medium/vest/breastplate/khan,/obj/effect/spawner/lootdrop/f13/weapon/gun/ammo/tier1,/obj/effect/spawner/lootdrop/f13/weapon/gun/ammo/tier1,/obj/effect/spawner/lootdrop/f13/weapon/gun/ammo/tier1,/turf/open/floor/wood_common/wood_common_light,/area/f13/building/khanfort)
"De" = (/obj/structure/destructible/tribal_torch/wall/lit{dir = 1; pixel_y = 28},/turf/open/floor/wood_common/wood_common_light,/area/f13/building/khanfort)
"Dn" = (/obj/structure/reagent_dispensers/fueltank,/turf/open/indestructible/ground/inside/mountain,/area/f13/tunnel/khanfort)
"DA" = (/obj/structure/destructible/tribal_torch/wall/lit{dir = 4},/turf/open/floor/wood_common,/area/f13/building/khanfort)
"Eh" = (/obj/structure/rack/shelf_metal,/obj/item/clothing/head/helmet/f13/khan/fullhelm,/obj/item/clothing/under/f13/khan,/obj/effect/decal/cleanable/dirt,/obj/effect/spawner/lootdrop/f13/weapon/gun/ballistic/low,/turf/open/floor/wood_common/wood_common_light,/area/f13/building/khanfort)
"EK" = (/obj/structure/wreck/trash/five_tires,/turf/open/indestructible/ground/outside/desert,/area/f13/wasteland)
"ER" = (/obj/machinery/smartfridge/bottlerack/drug_storage,/obj/effect/spawner/lootdrop/f13/medical/wasteland/meds/drug,/obj/structure/destructible/tribal_torch/wall/lit{dir = 1; pixel_y = 28},/turf/open/indestructible/ground/inside/mountain,/area/f13/tunnel/khanfort)
"Fa" = (/obj/structure/closet/crate/grave,/turf/open/indestructible/ground/outside/desert,/area/f13/wasteland)
"Fb" = (/turf/open/indestructible/ground/outside/desert,/area/f13/wasteland)
"Fg" = (/obj/structure/chair/stool/bar/bronze,/obj/effect/overlay/desert_side,/turf/open/floor/wood_common,/area/f13/building/khanfort)
"FL" = (/obj/structure/bed/mattress,/turf/open/indestructible/ground/inside/mountain,/area/f13/tunnel/khanfort)
"FQ" = (/obj/structure/bed/wooden,/obj/item/bedsheet/pirate,/turf/open/floor/wood_common/wood_common_dark,/area/f13/building/khanfort)
"FR" = (/obj/structure/destructible/tribal_torch/wall/lit{dir = 1; pixel_y = 28},/obj/structure/chair/pew/right{dir = 4},/turf/open/indestructible/ground/inside/mountain,/area/f13/tunnel/khanfort)
"Gl" = (/obj/structure/rack/shelf_metal,/obj/item/clothing/head/helmet/f13/khan,/obj/effect/spawner/lootdrop/f13/weapon/gun/ammo/tier1,/obj/effect/spawner/lootdrop/f13/weapon/gun/ammo/tier1,/obj/effect/spawner/lootdrop/f13/weapon/gun/ammo/tier1,/turf/open/floor/wood_common/wood_common_light,/area/f13/building/khanfort)
"Gt" = (/turf/closed/mineral/strong/wasteland,/area/f13/tunnel/khanfort)
"Gx" = (/obj/structure/destructible/tribal_torch/wall/lit{dir = 8},/turf/open/floor/wood_common,/area/f13/building/khanfort)
"GJ" = (/obj/structure/rack/shelf_metal,/obj/item/clothing/head/helmet/f13/khan/bandana,/obj/item/clothing/shoes/f13/military/khan_pelt,/obj/effect/spawner/lootdrop/f13/weapon/gun/ammo/tier1,/obj/effect/spawner/lootdrop/f13/weapon/gun/ammo/tier1,/obj/effect/spawner/lootdrop/f13/weapon/gun/ammo/tier1,/turf/open/floor/wood_common/wood_common_light,/area/f13/building/khanfort)
"GW" = (/obj/structure/destructible/tribal_torch/wall/lit,/obj/machinery/workbench/forge,/turf/open/indestructible/ground/inside/mountain,/area/f13/tunnel/khanfort)
"GX" = (/turf/open/indestructible/ground/outside/gravel/path_desert{dir = 4},/area/f13/wasteland)
"Hb" = (/obj/structure/fence{dir = 4},/turf/open/indestructible/ground/outside/desert,/area/f13/wasteland/khans)
"Hf" = (/obj/structure/chair/sofa/corp/right,/turf/open/indestructible/ground/outside/desert,/area/f13/wasteland)
"HW" = (/obj/structure/wreck/trash/two_tire,/turf/open/indestructible/ground/outside/desert,/area/f13/wasteland)
"In" = (/obj/structure/car/rubbish1,/turf/open/indestructible/ground/outside/desert,/area/f13/wasteland)
"Is" = (/obj/structure/chair/pew{dir = 8},/turf/open/indestructible/ground/inside/mountain,/area/f13/tunnel/khanfort)
"Iy" = (/obj/structure/wreck/trash/machinepile,/turf/open/indestructible/ground/outside/desert,/area/f13/wasteland)
"Jc" = (/obj/structure/chair/stool/bar,/turf/open/indestructible/ground/inside/mountain,/area/f13/tunnel/khanfort)
"Jh" = (/obj/structure/destructible/tribal_torch/wall/lit{dir = 8},/turf/open/floor/wood_common/wood_common_light,/area/f13/building/khanfort)
"Ju" = (/obj/item/reagent_containers/rag,/turf/open/indestructible/ground/inside/dirt,/area/f13/building/khanfort)
"Ki" = (/obj/effect/spawner/lootdrop/trash,/turf/open/indestructible/ground/outside/desert,/area/f13/wasteland)
"Kl" = (/obj/structure/destructible/tribal_torch/wall/lit,/turf/open/floor/wood_common/wood_common_light,/area/f13/building/khanfort)
"Ks" = (/obj/structure/chair/f13chair1{dir = 8},/turf/open/indestructible/ground/outside/desert,/area/f13/wasteland)
"Ky" = (/obj/structure/rack/shelf_metal,/obj/item/clothing/head/helmet/f13/khan/fullhelm,/obj/item/clothing/under/f13/khan,/obj/effect/spawner/lootdrop/f13/weapon/gun/ballistic/low,/turf/open/floor/wood_common/wood_common_light,/area/f13/building/khanfort)
"KF" = (/obj/machinery/smartfridge/bottlerack/drug_storage,/obj/effect/spawner/lootdrop/f13/medical/wasteland/meds/drug,/turf/open/indestructible/ground/inside/mountain,/area/f13/tunnel/khanfort)
"KT" = (/obj/structure/bed/mattress,/turf/open/indestructible/ground/inside/dirt,/area/f13/building/khanfort)
"Ln" = (/obj/structure/chair/f13chair1{dir = 4},/turf/open/indestructible/ground/outside/desert,/area/f13/wasteland)
"Lw" = (/obj/structure/fence/door,/turf/open/indestructible/ground/outside/gravel/path_desert,/area/f13/wasteland)
"Ly" = (/obj/structure/fence/corner{dir = 8},/turf/open/indestructible/ground/outside/desert,/area/f13/wasteland/khans)
"LN" = (/obj/effect/decal/cleanable/dirt,/turf/open/floor/wood_common/wood_common_light,/area/f13/building/khanfort)
"Ma" = (/turf/closed/indestructible/rock,/area/f13/tunnel/khanfort)
"MX" = (/obj/effect/decal/cleanable/dirt,/turf/open/indestructible/ground/inside/mountain,/area/f13/tunnel/khanfort)
"Na" = (/turf/closed/wall/f13/tentwall,/area/f13/building/khanfort)
"Ne" = (/obj/effect/overlay/desert_side{dir = 1},/turf/open/floor/wood_common,/area/f13/building/khanfort)
"No" = (/obj/item/flag/khan,/turf/open/indestructible/ground/outside/desert,/area/f13/wasteland)
"NH" = (/obj/structure/fence,/turf/open/indestructible/ground/outside/desert,/area/f13/wasteland/khans)
"Of" = (/obj/structure/destructible/tribal_torch/lit,/turf/open/indestructible/ground/inside/mountain,/area/f13/tunnel/khanfort)
"Ou" = (/obj/structure/fence/corner{dir = 4},/turf/open/indestructible/ground/outside/desert,/area/f13/wasteland/khans)
"OC" = (/obj/structure/table/wood/club,/obj/item/candle,/turf/open/indestructible/ground/inside/mountain,/area/f13/tunnel/khanfort)
"OK" = (/obj/structure/table,/obj/machinery/microwave,/obj/structure/destructible/tribal_torch/wall/lit{dir = 8},/turf/open/indestructible/ground/inside/mountain,/area/f13/tunnel/khanfort)
"OV" = (/obj/structure/obstacle/barbedwire/end{dir = 8},/turf/open/indestructible/ground/outside/desert,/area/f13/wasteland)
"OY" = (/turf/open/indestructible/ground/outside/gravel/path_desert,/area/f13/wasteland)
"PE" = (/obj/structure/simple_door/tent,/turf/open/indestructible/ground/inside/dirt,/area/f13/building/khanfort)
"PS" = (/turf/open/floor/wood_common/wood_common_light,/area/f13/building/khanfort)
"PU" = (/obj/structure/rack/shelf_metal,/obj/item/clothing/suit/toggle/labcoat/khan_jacket/coat,/obj/effect/spawner/lootdrop/f13/weapon/gun/ballistic/hobo,/turf/open/floor/wood_common/wood_common_light,/area/f13/building/khanfort)
"Qh" = (/obj/structure/destructible/tribal_torch/wall/lit{dir = 1; pixel_y = 28},/obj/structure/table/wood/club,/obj/item/candle,/turf/open/indestructible/ground/inside/mountain,/area/f13/tunnel/khanfort)
"Rb" = (/obj/structure/table/wood,/turf/open/floor/wood_common/wood_common_dark,/area/f13/building/khanfort)
"RG" = (/obj/structure/destructible/tribal_torch/wall/lit{dir = 1; pixel_y = 28},/obj/structure/table/wood/club,/turf/open/indestructible/ground/inside/mountain,/area/f13/tunnel/khanfort)
"RH" = (/obj/effect/decal/cleanable/dirt,/obj/structure/chair/stool/bar,/turf/open/indestructible/ground/inside/mountain,/area/f13/tunnel/khanfort)
"Sh" = (/turf/closed/indestructible/rock,/area/f13/wasteland)
"SA" = (/obj/structure/chair/pew{dir = 4},/turf/open/indestructible/ground/inside/mountain,/area/f13/tunnel/khanfort)
"SJ" = (/obj/structure/rack/shelf_metal,/obj/item/clothing/suit/toggle/labcoat/khan_jacket/coat,/obj/item/radio/headset/headset_khans,/obj/effect/spawner/lootdrop/f13/weapon/gun/ammo/tier1,/obj/effect/spawner/lootdrop/f13/weapon/gun/ammo/tier1,/obj/effect/spawner/lootdrop/f13/weapon/gun/ammo/tier1,/turf/open/floor/wood_common/wood_common_light,/area/f13/building/khanfort)
"SZ" = (/obj/structure/table/reinforced,/obj/machinery/chem_dispenser/drinks,/obj/effect/overlay/desert_side{dir = 1},/turf/open/floor/wood_common,/area/f13/building/khanfort)
"Tk" = (/obj/structure/fence/corner{dir = 1},/turf/open/indestructible/ground/outside/desert,/area/f13/wasteland/khans)
"TB" = (/turf/closed/wall/mineral/wood/nonmetal,/area/f13/building/khanfort)
"Uo" = (/obj/structure/table,/obj/item/storage/backpack/duffelbag/med/surgery,/turf/open/indestructible/ground/inside/mountain,/area/f13/tunnel/khanfort)
"Uw" = (/obj/structure/rack/shelf_metal,/obj/item/clothing/shoes/f13/military/khan,/obj/item/clothing/head/helmet/f13/khan/bandana,/obj/item/clothing/under/f13/khan,/obj/item/clothing/shoes/f13/military/khan_pelt,/obj/effect/spawner/lootdrop/f13/weapon/gun/ballistic/low,/turf/open/floor/wood_common/wood_common_light,/area/f13/building/khanfort)
"UP" = (/obj/structure/destructible/tribal_torch/wall/lit{dir = 8},/obj/structure/wreck/trash/three_barrels,/turf/open/indestructible/ground/outside/desert,/area/f13/wasteland)
"VU" = (/obj/structure/destructible/tribal_torch/wall/lit{dir = 8},/obj/effect/decal/cleanable/dirt,/turf/open/floor/wood_common/wood_common_light,/area/f13/building/khanfort)
"We" = (/obj/structure/chair/sofa/corp,/turf/open/indestructible/ground/outside/desert,/area/f13/wasteland)
"Wf" = (/obj/structure/simple_door/brokenglass,/turf/open/indestructible/ground/inside/mountain,/area/f13/tunnel/khanfort)
"WI" = (/obj/structure/chair/pew/right{dir = 8},/turf/open/indestructible/ground/inside/mountain,/area/f13/tunnel/khanfort)
"WY" = (/obj/structure/table,/obj/item/stack/medical/ointment/twelve,/obj/item/stack/medical/ointment/twelve,/obj/item/stack/medical/suture/emergency/fifteen,/obj/item/stack/medical/suture/emergency/fifteen,/obj/item/stack/medical/bruise_pack,/turf/open/indestructible/ground/inside/mountain,/area/f13/tunnel/khanfort)
"Xb" = (/obj/structure/destructible/tribal_torch/wall/lit{dir = 1; pixel_y = 28},/obj/structure/wreck/trash/four_barrels,/turf/open/indestructible/ground/outside/desert,/area/f13/wasteland)
"XP" = (/obj/structure/campfire,/turf/open/indestructible/ground/outside/desert,/area/f13/wasteland)
"XU" = (/obj/structure/table/wood/club,/turf/open/indestructible/ground/inside/mountain,/area/f13/tunnel/khanfort)
"Yb" = (/obj/structure/closet/crate/bin/trashbin,/turf/open/indestructible/ground/outside/desert,/area/f13/wasteland)
"Yh" = (/turf/open/indestructible/ground/outside/desert,/area/f13/wasteland/khans)
"YM" = (/obj/structure/obstacle/barbedwire,/turf/open/indestructible/ground/outside/desert,/area/f13/wasteland)
"ZE" = (/obj/structure/chair/f13chair1{dir = 1},/turf/open/indestructible/ground/outside/desert,/area/f13/wasteland)

(1,1,1) = {"
FbFbFbFbFbFbFbFbFbFbFbFbFbFbFbFbFbFbFbFbFbFbFbFbFbFbFbFbFbFbFbFbFbFbFbyIFbFbFbFbFbFbFbFbFbFbFbFbFbFb
FbFbFbFbFbFbFbFbFbFbFbFbFbFbFbFbFbFbFbFbFbFbFbFbFbFbyIFbFbFbyIFbFbFbyIyIyIyIyIFbFbFbFbFbFbFbFbFbFbFb
FbFbFbFbFbFbFbFbFbFbFbFbFbFbFbFbFbyIFbyIyIyIFbyIFbFbyIyIFbFbFbyIyIyIyIyIyIyIyIyIFbFbFbFbFbFbFbFbFbFb
FbFbFbFbFbFbFbFbFbFbFbFbyIFbyIyIFbyIyIyIyIyIyIyIyIyIyIyIShyIyIShyIyIShShyIyIyIyIyIFbFbFbFbFbFbFbFbFb
FbFbFbFbFbFbFbFbFbyIFbyIyIyIyIyIyIyIyIyIShyIShyIyIShyIyIyIyIShyIyIShyIyIShyIyIyIyIyIFbFbFbFbFbFbFbFb
FbFbFbFbFbFbFbyIyIFbFbyIyIyIyIyIyIyIyIShyIShyIShShyIShyIShyIyIyIShyIShyIyIShyIyIyIyIyIyIFbFbFbFbFbFb
FbFbFbFbFbFbFbFbFbyIFbyIyIyIyIyIyIyIyIShyIyIyIyIyIyIyIyIyIMaGtGtGtGtGtMaGtGtGtMaGtGtMayIyIyIyIFbFbFb
FbFbFbFbFbFbFbFbFbFbFbyIyIyIyIyIyIyIyIyIyIShyIGtGtGtGtlvGtGtWYOfhgUolxenitERKFenMaGtGtShyIyIyIyIFbFb
FbFbFbFbFbFbFbyIyIFbyIyIyIyIyIyIyIyIyIShyIyIyIGtuEfyaRlvFLGtqTlvlvlvlxrXlvlvlvrXGtGtGtyIShyIyIyIFbFb
FbFbFbFbFbFbFbFbFbFbyIyIyIyIyIyIyIyIyIShyIShyIlvlvMXMXlvGtGthClvlvlvlxlvlvlvlvlvfxfxGtyIyIyIyIyIFbFb
FbFbFbFbFbFbFbFbyIFbyIyIyIyIyIyIyIyIyIyIShyIyIGtOKpJgdeOGtFLlvwllvsvlxoEpFlvwllvlvlvGtyIyIShyIyIyIFb
FbFbFbFbFbFbFbFbFbFbyIyIyIyIyIyIyIyIyIyIyIyIyIlvlvMXMXlvGtGtzmlxlxlxlxlxlxlxlxlxlxzmGtyIyIyIShyIyIFb
FbFbFbFbFbFbFbFbFbFbyIyIyIyIyIyIyIyIyIyIyIShyIGtcAlvwllvlvzmlvFRXUhcsZRGhcAlQhhclvlvlmaRuByIyIShyIFb
FbFbFbFbFbFbFbFbFbFbqggxyIyIyIyIyIyIyIyIyIyIShGtGtGtGtGtGtGtbQSAXUIsSAOCIsSAXUIslvRHlmlvvzyIShyIShFb
FbFbFbFbFbFbFbFbFbFbYMgxyIyIyIyIyIyIyIyIyIyIShyIyIyIyIyIyIGtlvjmOCWIjmXUWIjmXUWIlvJclmlvyzyIShyIFbFb
FbFbFbFbFbFbFbFbFbFbYMgxFbyIFbyIyIyIJutzyIyIyIShyIyIyIyIyIFLlvMXMXlvlvlvlvlvlvlvMXlvlvwllvShyIyIFbFb
FbFbFbFbFbFbFbFbFbsbYMgxFaFaFaFbFbNaNaPEyIyIyIyIyIyIyIyIyIGtlvMXlvwlMXMXuZDnGWlvdDsVlxyIShyIyIFbFbFb
FbFbFbFbFbFbFbFbFbFbYMgxFbFbFbFbsbFbFbFbFbFbFbFbyIyIHWEKyIGtlxWflxlxlxlxlxlxlxlxlxlxlxyIyIyIFbFbFbFb
FbFbFbFbFbFbFbFbFbFbYMgxFbFbTBTBTBTBTBTBTBFbFbFbFbFbFbHWFbFbhNxBXbBDIyFbFbFbFbFbFbFbFbFbyIqgFbFbFbFb
FbFbFbFbFbFbFbFbFbFbYMgxFbFbTBFQcDcDcDzATBFbFbsbFbFbFbFbFbmdFbxBFbFbFbFbFbFbFbFbFbFbmdFbtFYMFbFbFbFb
FbFbFbFbFbFbFbFbFbFbYMgxFbFbTBcDcDpXcDwckuFbFbFbFbKiFbFbFbFbFbxBFbFbLyHbHbHbHbHbOuFbFbFbtFYMFbFbFbFb
FbFbFbFbFbFbFbFbFbFbYMgxFbFbrGzAcDcDuQRbTBFbFbFbFbFbFbFbFbFbtOqsFbFblSdoYhYhYhdoNHFbKiFbtFYMFbFbFbFb
FbFbFbFbFbFbFbFbFbFbYMgxFbFbTBTBTBTBTBTBTBFbFbFbFbFbAdFbaqFbOYFbbAFblSYhYhYhYhYhNHFbFbFbtFYMFbFbFbFb
FbFbFbFbFbFbFbFbFbFbYMgxsbFbFbFbFbFbFbFbFbFbFbFbFbFbFbFbFbFbzYGXGXyRefYhYhYhYhYhNHFbInFbtFYMFbFbFbFb
FbFbFbFbFbFbFbFbFbFbYMgxFbFbnWBqBqnWnWBqBqnWYbFbsbFbFbFbFbFbOYFbFbFblSYhYhYhYhYhNHFbFbFbtFYMFbFbFbFb
FbFbFbFbFbFbFbFbFbFbYMgxFbFbBqKyLNrhDexCnRBqFbFbFbFbHfWesXFbOYFbFbFblSdoYhYhYhdoNHFbFbFbtFYMFbFbFbFb
FbFbFbsUFbFbFbFbFbFbYMgxFbFbBqPUPSUwPSASPSBqFbFbFbLnrZFbFbFbOYFbFbFbTkHbHbHbHbHbrbFbFbFbtFYMFbFbFbFb
FbFbFbFbFbFbFbFbFbFbYMgxFbFbnWJhLNPSPSLNPSnWzTFbFbFbFbXPFbKsOYFbsbFbFbKiFbFbFbFbFbFbFbsbtFYMFbFbFbFb
FbFbFbFbFbFbFbFbFbsbYMgxFbFbnWVUPSPSPSPSPSBsFbFbFbLnFbFbFbFbOYFbFbFbFbFbFbFbFbFbFbFbFbFbtFYMFbFbFbFb
FbFbFbFbFbFbFbFbFbFbYMgxFbFbfJBUPSSJPSEhPSnWUPFbFbFbFbZEFbFbOYFbFbFbNaNaPENaFbNaPENaNaFbtFYMFbFbFbFb
FbFbFbFbFbFbFbFbFbFbYMgxFbFbBqfiPSyEKlGJGlnWaFFbFbFbFbFbFbFbOYFbFbaqNazazaNaFbNazazaNaFbtFYMFbFbFbFb
FbFbFbFbFbFbFbFbFbFbYMgxFbFbnWBqBqnWnWBqBqnWaHNeBMSZlkHWFbFbOYFbFbiyNaKTKTNaFbNaKTKTNaFbtFYMFbFbFbFb
FbFbFbFbFbFbFbFbFbFbYMgxFbFbFbFbFbFbFbFbFbTBGxmJmJmJDATBFbFbOYFbFbFbNaNaNaNaFbNaNaNaNaFbtFYMsbFbFbFb
FbFbFbFbFbFbFbFbFbFbYMgxFbsbFbFbFbFbFbFbFbTBnLnLnLmJmJTBFbsbOYsbFbFbFbFbFbFbFbFbFbFbFbFbtFYMFbFbFbFb
FbFbFbFbFbFbFbFbFbFbYMxscBcBcBcBcBcBcBcBcBTBnEnEnEnEnETBcBcBLwcBcBcBcBcBcBcBcBcBcBcBcBcBlfYMFbFbFbFb
FbFbFbFbFbFbFbFbFbFbdebFbFbFbFbFbFbFbFiCFbTBvVFgFgFgqlTBFbNoFbNoFbFbFbiCFbbFbFbFbFbFbFbFbFOVFbFbFbFb
FbFbFbFbFbFbFbFbFbFbFbFbFbFbFbFbFbFbFbFbFbojFbFbFbFbFbojFbFbFbFbFbFbFbsbFbFbFbFbFbFbFbFbsbFbFbFbFbFb
FbFbFbFbFbFbFbFbFbFbsbFbFbFbFbFbFbFbFbFbFbFbFbFbFbFbFbFbFbFbFbFbFbFbFbFbFbFbFbFbFbFbFbFbFbFbFbFbFbFb
FbFbFbFbFbFbFbFbFbFbFbFbFbsUFbFbFbFbiJFbFbFbFbFbFbFbFbFbFbFbFbFbInFbFbFbFbFbFbFbFbFbFbFbFbFbFbFbFbFb
FbFbFbFbFbFbFbFbFbFbFbFbFbFbFbFbFbFbFbFbFbFbFbFbFbFbFbFbFbFbFbFbFbFbFbFbFbFbFbFbFbFbFbFbFbFbFbFbFbFb
"}
