"ak" = (/obj/structure/curtain{color = "#5c131b"; pixel_y = 32},/turf/open/floor/plasteel/f13/stone,/area/f13/ncr_main)
"am" = (/obj/machinery/light{dir = 4},/turf/open/floor/plasteel/f13/stone,/area/f13/ncr)
"aB" = (/obj/structure/bed,/obj/item/bedsheet/medical,/obj/machinery/light{dir = 4},/turf/open/floor/plasteel/f13/stone,/area/f13/ncr)
"aC" = (/obj/structure/railing,/obj/machinery/light/floor,/turf/open/floor/plasteel/f13/stone,/area/f13/ncr)
"bh" = (/obj/structure/fence,/turf/open/indestructible/ground/outside/desert,/area/f13/wasteland/ncr)
"cd" = (/obj/structure/toilet{dir = 8},/obj/machinery/light/small{dir = 4},/turf/open/floor/plasteel/f13/stone,/area/f13/ncr)
"cK" = (/obj/structure/railing,/turf/open/floor/plasteel/f13/stone,/area/f13/ncr)
"cN" = (/obj/structure/table/reinforced,/obj/machinery/reagentgrinder,/turf/open/floor/plasteel/f13/stone,/area/f13/ncr)
"cO" = (/obj/structure/cable{icon_state = "1-4"},/obj/structure/cable{icon_state = "1-2"},/obj/machinery/autolathe/ammobench,/turf/open/floor/plasteel/f13/stone,/area/f13/ncr_main)
"db" = (/obj/effect/landmark/start/f13/ncrconscript,/turf/open/indestructible/ground/outside/road,/area/f13/ncr)
"dq" = (/obj/machinery/door/unpowered/celldoor,/turf/open/floor/plasteel/f13/stone,/area/f13/ncr)
"em" = (/obj/structure/shelf_wood,/obj/item/clothing/head/hardhat/ncr,/turf/open/floor/plasteel/f13/stone,/area/f13/ncr_main)
"en" = (/obj/structure/fence,/turf/open/indestructible/ground/outside/desert,/area/f13/wasteland)
"eu" = (/obj/structure/urinal{pixel_y = 29},/turf/open/floor/plasteel/f13/stone,/area/f13/ncr)
"eH" = (/obj/structure/bed/mattress,/turf/open/indestructible/ground/outside/road,/area/f13/ncr)
"fd" = (/obj/machinery/light{dir = 1},/obj/structure/closet/locker,/obj/item/storage/box/handcuffs,/obj/item/melee/classic_baton/militarypolice,/obj/item/clothing/head/f13/ncr/mp,/obj/item/clothing/head/f13/ncr/steelpot_mp,/obj/effect/spawner/bundle/f13/varmint,/turf/open/floor/plasteel/f13/stone,/area/f13/ncr)
"fS" = (/obj/machinery/light,/obj/structure/cable{icon_state = "1-2"},/turf/open/floor/plasteel/f13/stone,/area/f13/ncr_main)
"gh" = (/obj/machinery/light,/obj/structure/closet/locker/fridge,/turf/open/floor/plasteel/f13/stone,/area/f13/ncr)
"gn" = (/obj/structure/decoration/train,/turf/closed/wall/f13/store,/area/f13/ncr_main)
"go" = (/obj/structure/destructible/tribal_torch/lit,/turf/open/indestructible/ground/outside/desert,/area/f13/wasteland)
"gs" = (/obj/effect/landmark/start/f13/ncrcaptain,/turf/open/floor/plasteel/f13/stone,/area/f13/ncr_main)
"gG" = (/obj/structure/table/wood,/obj/machinery/reagentgrinder,/turf/open/floor/plasteel/f13/stone,/area/f13/ncr)
"gK" = (/obj/machinery/light{dir = 8},/turf/open/floor/plasteel/f13/stone,/area/f13/ncr_main)
"hp" = (/obj/structure/cable{icon_state = "4-8"},/obj/machinery/autolathe,/turf/open/floor/plasteel/f13/stone,/area/f13/ncr_main)
"ht" = (/obj/effect/landmark/start/f13/ncrlieutenant,/turf/open/floor/plasteel/f13/stone,/area/f13/ncr_main)
"if" = (/obj/structure/shelf_wood,/obj/item/clothing/under/f13/ncr/ncr_shorts,/obj/item/stack/sheet/mineral/concrete/fifty,/obj/item/stack/sheet/mineral/concrete/fifty,/turf/open/floor/plasteel/f13/stone,/area/f13/ncr_main)
"is" = (/obj/effect/overlay/desert_side{dir = 8},/obj/effect/overlay/desert_side,/turf/open/indestructible/ground/outside/dirt,/area/f13/wasteland/ncr)
"iw" = (/obj/machinery/computer/card/ncr,/turf/open/floor/plasteel/f13/stone,/area/f13/ncr_main)
"iA" = (/turf/closed/indestructible/f13/matrix,/area/f13/wasteland/ncr)
"iD" = (/obj/structure/sink{dir = 4; pixel_x = 12},/obj/structure/mirror{pixel_x = 30},/turf/open/floor/plasteel/f13/stone,/area/f13/ncr)
"jd" = (/turf/open/indestructible/ground/outside/desert,/area/f13/wasteland/ncr)
"jy" = (/turf/closed/indestructible/f13/subway,/area/f13/ncr_main)
"jI" = (/obj/machinery/light,/turf/open/floor/plasteel/f13/stone,/area/f13/ncr)
"jR" = (/obj/structure/cable{icon_state = "4-8"},/turf/closed/wall/f13/store,/area/f13/wasteland/ncr)
"kc" = (/obj/effect/overlay/desert_side{dir = 8},/turf/open/indestructible/ground/outside/dirt,/area/f13/wasteland/ncr)
"km" = (/obj/structure/bed/mattress,/turf/open/floor/plasteel/f13/stone,/area/f13/ncr)
"ks" = (/obj/structure/sign/poster/ncr/democracy,/turf/closed/wall/f13/store,/area/f13/ncr_main)
"ky" = (/obj/machinery/light{dir = 8},/turf/open/floor/plasteel/f13/stone,/area/f13/ncr)
"lc" = (/obj/effect/overlay/desert_side,/turf/open/indestructible/ground/outside/dirt,/area/f13/wasteland/ncr)
"li" = (/turf/closed/wall/f13/tentwall,/area/f13/ncr)
"lq" = (/obj/structure/sign/poster/ncr/keep_to_myself,/turf/closed/wall/f13/store,/area/f13/ncr_main)
"lD" = (/obj/effect/spawner/structure/window/reinforced,/obj/structure/cable{icon_state = "4-8"},/turf/open/floor/plasteel/f13/stone,/area/f13/ncr_main)
"lI" = (/obj/structure/simple_door/metal/store,/turf/open/floor/plasteel/f13/stone,/area/f13/ncr)
"lP" = (/obj/machinery/light,/obj/item/reagent_containers/glass/rag,/obj/item/reagent_containers/glass/bucket,/turf/open/floor/plasteel/f13/stone,/area/f13/ncr)
"lW" = (/obj/effect/landmark/start/f13/ncrmp,/turf/open/floor/plasteel/f13/stone,/area/f13/ncr)
"mw" = (/obj/machinery/power/terminal,/obj/structure/cable,/turf/open/floor/plasteel/f13/stone,/area/f13/ncr_main)
"mB" = (/obj/structure/chair/bench{dir = 1},/turf/open/floor/plasteel/f13/stone,/area/f13/ncr)
"mR" = (/obj/structure/table/wood,/obj/machinery/chem_dispenser/drinks,/turf/open/floor/plasteel/f13/stone,/area/f13/ncr)
"nb" = (/obj/structure/shelf_wood,/obj/item/clothing/under/f13/ncr_female_officer,/turf/open/floor/plasteel/f13/stone,/area/f13/ncr_main)
"nq" = (/turf/open/floor/plasteel/f13/stone,/area/f13/wasteland/ncr)
"nt" = (/obj/machinery/power/port_gen/pacman/diesel,/obj/structure/cable{icon_state = "0-2"},/obj/structure/cable{icon_state = "2-4"},/turf/open/floor/plasteel/f13/stone,/area/f13/ncr_main)
"nC" = (/obj/machinery/light,/turf/open/floor/plasteel/f13/stone,/area/f13/ncr_main)
"oG" = (/obj/structure/bed/mattress,/obj/machinery/light/small,/turf/open/indestructible/ground/outside/road,/area/f13/ncr)
"oV" = (/obj/structure/table/wood,/obj/item/storage/backpack/duffelbag/med/surgery,/obj/item/storage/backpack/duffelbag/med/surgery,/obj/item/storage/backpack/duffelbag/med/surgery,/turf/open/floor/plasteel/f13/stone,/area/f13/ncr)
"pg" = (/obj/structure/destructible/tribal_torch/wall/lit{dir = 8; light_color = "#f4e3b0"},/turf/open/indestructible/ground/outside/road,/area/f13/wasteland/ncr)
"pu" = (/obj/machinery/mineral/ore_redemption,/turf/open/floor/plasteel/f13/stone,/area/f13/ncr_main)
"pU" = (/obj/structure/cable{icon_state = "1-8"},/turf/closed/wall/f13/store,/area/f13/ncr_main)
"qc" = (/obj/structure/chalkboard,/turf/open/floor/plasteel/f13/stone,/area/f13/ncr)
"rd" = (/obj/structure/table/reinforced,/turf/open/floor/plasteel/f13/stone,/area/f13/ncr)
"ri" = (/obj/effect/landmark/start/f13/ncrmedofficer,/turf/open/floor/plasteel/f13/stone,/area/f13/ncr)
"rj" = (/obj/structure/mirror{pixel_x = 30},/obj/structure/sink{dir = 4; pixel_x = 12},/turf/open/floor/plasteel/f13/stone,/area/f13/ncr)
"rv" = (/obj/structure/sign/poster/ncr/loaded,/turf/closed/wall/f13/store,/area/f13/ncr_main)
"sm" = (/obj/effect/landmark/start/f13/ncrheavytrooper,/turf/open/floor/plasteel/f13/stone,/area/f13/ncr)
"sw" = (/obj/structure/cable{icon_state = "4-8"},/turf/open/floor/plasteel/f13/stone,/area/f13/ncr_main)
"tH" = (/obj/structure/curtain{color = "#5c131b"; pixel_x = -32},/turf/open/floor/plasteel/f13/stone,/area/f13/ncr_main)
"uf" = (/obj/structure/table/wood,/obj/machinery/chem_dispenser/drinks/beer,/turf/open/floor/plasteel/f13/stone,/area/f13/ncr)
"uM" = (/obj/machinery/iv_drip,/turf/open/floor/plasteel/f13/stone,/area/f13/ncr)
"wg" = (/obj/structure/bed/mattress,/obj/machinery/light/small{dir = 4},/turf/open/indestructible/ground/outside/road,/area/f13/ncr)
"wZ" = (/turf/closed/wall/f13/store,/area/f13/wasteland)
"xu" = (/obj/structure/shelf_wood,/obj/item/clothing/suit/armor/medium/vest/ncr,/obj/item/clothing/under/f13/ncr/ncr_shorts,/obj/item/stack/sheet/mineral/concrete/fifty,/obj/item/stack/sheet/mineral/concrete/fifty,/turf/open/floor/plasteel/f13/stone,/area/f13/ncr_main)
"xv" = (/obj/machinery/light{dir = 4},/turf/open/floor/plasteel/f13/stone,/area/f13/wasteland/ncr)
"xy" = (/turf/open/indestructible/ground/outside/dirt,/area/f13/wasteland/ncr)
"xG" = (/obj/structure/destructible/tribal_torch/wall/lit{dir = 1; pixel_y = 12},/turf/open/indestructible/ground/outside/sidewalk,/area/f13/wasteland/ncr)
"xI" = (/obj/effect/spawner/structure/window/reinforced,/turf/open/floor/plasteel/f13/stone,/area/f13/ncr_main)
"xT" = (/obj/structure/cable{icon_state = "1-2"},/obj/structure/shelf_wood,/obj/item/clothing/suit/armor/medium/vest/ncr,/obj/item/clothing/under/f13/ncr/ncr_shorts,/obj/item/stack/sheet/mineral/concrete/fifty,/obj/item/stack/sheet/mineral/concrete/fifty,/turf/open/floor/plasteel/f13/stone,/area/f13/ncr_main)
"yf" = (/obj/structure/cable{icon_state = "1-2"},/obj/structure/shelf_wood,/obj/item/clothing/suit/armor/ncrarmor/conscript,/obj/item/clothing/suit/armor/ncrarmor/conscript,/obj/item/clothing/under/f13/ncr/conscript,/turf/open/floor/plasteel/f13/stone,/area/f13/ncr_main)
"yn" = (/obj/structure/barricade/bars,/obj/structure/table/reinforced,/obj/structure/barricade/sandbags,/turf/open/floor/plasteel/f13/stone,/area/f13/ncr)
"yq" = (/obj/structure/barricade/bars,/turf/open/floor/plasteel/f13/stone,/area/f13/ncr)
"yC" = (/obj/structure/closet/locker,/obj/item/storage/box/handcuffs,/obj/item/melee/classic_baton/militarypolice,/obj/item/clothing/head/f13/ncr/mp,/obj/item/clothing/head/f13/ncr/steelpot_mp,/obj/effect/spawner/bundle/f13/varmint,/turf/open/floor/plasteel/f13/stone,/area/f13/ncr)
"yN" = (/obj/structure/closet/ammunitionlocker,/turf/open/floor/plasteel/f13/stone,/area/f13/ncr_main)
"zM" = (/turf/closed/indestructible/f13/subway,/area/f13/wasteland/ncr)
"Ab" = (/obj/machinery/light{dir = 4},/turf/open/floor/plasteel/f13/stone,/area/f13/ncr_main)
"Af" = (/obj/machinery/workbench/assbench,/turf/open/floor/plasteel/f13/stone,/area/f13/ncr_main)
"Ag" = (/obj/machinery/power/port_gen/pacman/diesel,/obj/structure/cable{icon_state = "0-8"},/obj/structure/cable{icon_state = "4-8"},/turf/open/floor/plasteel/f13/stone,/area/f13/ncr_main)
"Ap" = (/turf/open/indestructible/ground/outside/sidewalk,/area/f13/wasteland/ncr)
"AA" = (/obj/structure/cable{icon_state = "4-8"},/turf/closed/wall/f13/store,/area/f13/ncr_main)
"AZ" = (/obj/machinery/light/small{dir = 1},/turf/open/floor/plasteel/f13/stone,/area/f13/ncr)
"Br" = (/obj/machinery/workbench/forge,/turf/open/floor/plasteel/f13/stone,/area/f13/ncr_main)
"BE" = (/turf/open/indestructible/ground/outside/road,/area/f13/ncr)
"BL" = (/obj/item/flag/ncr,/turf/open/indestructible/ground/outside/road,/area/f13/wasteland)
"Ce" = (/obj/effect/landmark/start/f13/ncrconscript,/obj/machinery/light/small,/turf/open/indestructible/ground/outside/road,/area/f13/ncr)
"Ch" = (/obj/structure/cable{icon_state = "4-8"},/obj/structure/table/wood,/obj/item/stack/sheet/glass/fifty,/obj/item/stack/sheet/metal/fifty,/obj/item/stack/sheet/metal/fifty,/turf/open/floor/plasteel/f13/stone,/area/f13/ncr_main)
"Cj" = (/obj/structure/destructible/tribal_torch/wall/lit{dir = 8; light_color = "#f4e3b0"},/turf/open/indestructible/ground/outside/sidewalk,/area/f13/wasteland/ncr)
"CB" = (/turf/open/floor/plasteel/f13/stone,/area/f13/wasteland)
"CF" = (/obj/machinery/light,/obj/item/reagent_containers/glass/bucket,/obj/item/reagent_containers/glass/rag,/turf/open/floor/plasteel/f13/stone,/area/f13/ncr)
"Dv" = (/turf/open/indestructible/ground/outside/road,/area/f13/wasteland)
"DA" = (/obj/structure/barricade/bars,/obj/structure/table/reinforced,/obj/structure/barricade/sandbags,/turf/open/floor/plasteel/f13/stone,/area/f13/wasteland)
"DL" = (/turf/open/floor/plasteel/f13/stone,/area/f13/ncr)
"DQ" = (/obj/machinery/power/apc/fusebox/north,/obj/structure/cable{icon_state = "0-8"},/turf/open/floor/plasteel/f13/stone,/area/f13/ncr_main)
"DV" = (/turf/closed/wall/f13/store,/area/f13/ncr_main)
"Ec" = (/obj/effect/landmark/start/f13/ncrrep,/turf/open/floor/plasteel/f13/stone,/area/f13/ncr)
"Em" = (/obj/machinery/light/floor,/turf/open/floor/plasteel/f13/stone,/area/f13/ncr)
"Fl" = (/obj/structure/simple_door/metal/store,/turf/open/floor/plasteel/f13/stone,/area/f13/ncr_main)
"GD" = (/obj/effect/landmark/start/f13/ncrfirstsergeant,/turf/open/floor/plasteel/f13/stone,/area/f13/ncr_main)
"GL" = (/obj/structure/table/reinforced,/obj/machinery/chem_lab,/turf/open/floor/plasteel/f13/stone,/area/f13/ncr)
"GP" = (/turf/closed/wall/f13/store,/area/f13/wasteland/ncr)
"GQ" = (/obj/structure/cable{icon_state = "2-4"},/turf/closed/wall/f13/store,/area/f13/wasteland/ncr)
"Hn" = (/obj/structure/simple_door/house,/turf/open/floor/plasteel/f13/stone,/area/f13/ncr)
"Hp" = (/obj/structure/shelf_wood,/obj/item/clothing/suit/armor/ncrarmor/conscript,/obj/item/clothing/suit/armor/ncrarmor/conscript,/obj/item/clothing/under/f13/ncr/conscript,/turf/open/floor/plasteel/f13/stone,/area/f13/ncr_main)
"Hw" = (/obj/machinery/light/small{dir = 4},/turf/open/floor/plasteel/f13/stone,/area/f13/ncr)
"Ib" = (/obj/item/flag/ncr,/turf/open/floor/plasteel/f13/stone,/area/f13/ncr)
"Ic" = (/obj/structure/table/wood,/obj/machinery/microwave,/turf/open/floor/plasteel/f13/stone,/area/f13/ncr)
"Ii" = (/obj/machinery/light,/obj/structure/table/wood,/obj/machinery/processor/chopping_block,/turf/open/floor/plasteel/f13/stone,/area/f13/ncr)
"Ip" = (/obj/structure/cable{icon_state = "1-8"},/turf/closed/wall/f13/store,/area/f13/ncr)
"II" = (/obj/machinery/workbench/fbench,/turf/open/floor/plasteel/f13/stone,/area/f13/ncr_main)
"IL" = (/obj/machinery/chem_master,/obj/machinery/light{dir = 1},/turf/open/floor/plasteel/f13/stone,/area/f13/ncr)
"IW" = (/obj/structure/destructible/tribal_torch/wall/lit,/turf/open/indestructible/ground/outside/sidewalk,/area/f13/wasteland/ncr)
"Jb" = (/obj/machinery/power/port_gen/pacman/diesel,/obj/structure/cable{icon_state = "0-8"},/turf/open/floor/plasteel/f13/stone,/area/f13/ncr_main)
"Jc" = (/turf/open/floor/plasteel/stairs,/area/f13/ncr)
"Jn" = (/obj/structure/curtain{color = "#5c131b"; pixel_y = -32},/turf/open/floor/plasteel/f13/stone,/area/f13/ncr_main)
"Jz" = (/obj/machinery/light{dir = 4},/obj/structure/table/wood,/turf/open/floor/plasteel/f13/stone,/area/f13/ncr)
"JH" = (/obj/machinery/door/unpowered/secure_NCR,/turf/open/floor/plasteel/f13/stone,/area/f13/ncr_main)
"JR" = (/obj/structure/destructible/tribal_torch/lit,/turf/open/indestructible/ground/outside/sidewalk,/area/f13/wasteland)
"Ks" = (/obj/machinery/iv_drip,/obj/machinery/light{dir = 8},/turf/open/floor/plasteel/f13/stone,/area/f13/ncr)
"KD" = (/obj/structure/cable{icon_state = "1-2"},/turf/open/floor/plasteel/f13/stone,/area/f13/ncr_main)
"KL" = (/turf/open/indestructible/ground/outside/road,/area/f13/wasteland/ncr)
"KW" = (/turf/open/indestructible/ground/outside/desert,/area/f13/wasteland)
"Lp" = (/obj/structure/table/reinforced,/obj/item/reagent_containers/spray/cleaner,/obj/item/reagent_containers/spray/cleaner,/turf/open/floor/plasteel/f13/stone,/area/f13/ncr)
"Lu" = (/obj/structure/cable{icon_state = "2-4"},/turf/closed/wall/f13/store,/area/f13/ncr)
"LC" = (/obj/machinery/light{dir = 1},/turf/open/floor/plasteel/f13/stone,/area/f13/ncr_main)
"Ml" = (/obj/machinery/workbench,/turf/open/floor/plasteel/f13/stone,/area/f13/ncr_main)
"NJ" = (/obj/structure/bed,/obj/item/bedsheet/medical,/turf/open/floor/plasteel/f13/stone,/area/f13/ncr)
"Ob" = (/turf/open/floor/plasteel/f13/stone,/area/f13/ncr_main)
"Oc" = (/turf/open/indestructible/ground/outside/sidewalk,/area/f13/wasteland)
"Ol" = (/obj/structure/simple_door/tent,/turf/open/indestructible/ground/outside/road,/area/f13/ncr)
"Op" = (/obj/structure/shelf_wood,/obj/item/clothing/head/f13/ncr/standard,/turf/open/floor/plasteel/f13/stone,/area/f13/ncr_main)
"Ou" = (/obj/machinery/power/apc/fusebox/east,/obj/structure/cable,/turf/open/floor/plasteel/f13/stone,/area/f13/ncr)
"OD" = (/obj/structure/closet/crate/freezer/blood,/turf/open/floor/plasteel/f13/stone,/area/f13/ncr)
"OP" = (/obj/structure/urinal{pixel_y = 29},/obj/machinery/light/small{dir = 4},/turf/open/floor/plasteel/f13/stone,/area/f13/ncr)
"OQ" = (/obj/effect/landmark/start/f13/ncrveteranranger,/turf/open/floor/plasteel/f13/stone,/area/f13/ncr)
"OR" = (/obj/machinery/power/smes,/obj/structure/cable{icon_state = "0-2"},/turf/open/floor/plasteel/f13/stone,/area/f13/ncr_main)
"OW" = (/obj/structure/cable{icon_state = "4-8"},/obj/structure/shelf_wood,/obj/item/clothing/shoes/f13/military/ncr,/turf/open/floor/plasteel/f13/stone,/area/f13/ncr_main)
"Pu" = (/obj/structure/chair/bench,/turf/open/floor/plasteel/f13/stone,/area/f13/ncr)
"Qc" = (/obj/structure/shelf_wood,/obj/effect/spawner/bundle/f13/varmint,/turf/open/floor/plasteel/f13/stone,/area/f13/ncr_main)
"Qr" = (/turf/closed/indestructible/f13vaultrusted,/area/f13/wasteland/ncr)
"Qw" = (/obj/structure/destructible/tribal_torch/wall/lit,/turf/open/indestructible/ground/outside/road,/area/f13/wasteland/ncr)
"Rc" = (/obj/structure/barricade/sandbags,/turf/open/indestructible/ground/outside/sidewalk,/area/f13/wasteland/ncr)
"RL" = (/obj/structure/shelf_wood,/obj/item/stack/sheet/mineral/plasma/fifty,/turf/open/floor/plasteel/f13/stone,/area/f13/ncr_main)
"RP" = (/obj/structure/closet/crate/freezer/blood/anchored,/turf/open/floor/plasteel/f13/stone,/area/f13/ncr)
"RR" = (/obj/effect/spawner/structure/window/reinforced,/turf/open/floor/plasteel/f13/stone,/area/f13/ncr)
"RY" = (/obj/structure/table/optable,/turf/open/floor/plasteel/f13/stone,/area/f13/ncr)
"SK" = (/obj/structure/toilet,/obj/machinery/light/small{dir = 1},/turf/open/floor/plasteel/f13/stone,/area/f13/ncr)
"Tc" = (/obj/structure/shelf_wood,/obj/item/clothing/shoes/f13/military/ncr,/turf/open/floor/plasteel/f13/stone,/area/f13/ncr_main)
"TA" = (/obj/machinery/light,/obj/structure/closet/fridge/meat,/turf/open/floor/plasteel/f13/stone,/area/f13/ncr)
"TG" = (/obj/structure/closet/fridge/standard,/turf/open/floor/plasteel/f13/stone,/area/f13/ncr)
"Ua" = (/turf/closed/indestructible/f13/obsidian,/area/f13/wasteland)
"Uj" = (/obj/structure/table/wood,/turf/open/floor/plasteel/f13/stone,/area/f13/ncr)
"Um" = (/obj/effect/landmark/start/f13/ncrtrooper,/turf/open/floor/plasteel/f13/stone,/area/f13/ncr)
"Uo" = (/obj/machinery/light{dir = 1},/obj/structure/shelf_wood,/obj/item/stack/sheet/mineral/plasma/fifty,/turf/open/floor/plasteel/f13/stone,/area/f13/ncr_main)
"Vb" = (/obj/structure/fluff/rails{dir = 4},/turf/open/indestructible/ground/outside/dirt,/area/f13/wasteland/ncr)
"VF" = (/obj/machinery/light{dir = 1},/turf/open/floor/plasteel/f13/stone,/area/f13/ncr)
"VZ" = (/obj/effect/landmark/start/f13/ncrconscript,/obj/machinery/light/small{dir = 4},/turf/open/indestructible/ground/outside/road,/area/f13/ncr)
"Wm" = (/obj/item/flag/ncr,/turf/open/indestructible/ground/outside/sidewalk,/area/f13/wasteland/ncr)
"WD" = (/obj/structure/cable{icon_state = "4-8"},/obj/structure/shelf_wood,/obj/item/clothing/head/helmet/f13/combat/ncr,/obj/item/clothing/shoes/f13/mutie/boots/ncr/ranger,/turf/open/floor/plasteel/f13/stone,/area/f13/ncr_main)
"WO" = (/obj/structure/railing{dir = 10},/obj/item/flag/ncr,/turf/open/floor/plasteel/f13/stone,/area/f13/ncr)
"WQ" = (/obj/structure/closet/secure_closet/freezer/fridge,/turf/open/floor/plasteel/f13/stone,/area/f13/ncr)
"Xy" = (/obj/structure/fence{dir = 4},/turf/open/indestructible/ground/outside/desert,/area/f13/wasteland)
"XC" = (/obj/structure/railing{dir = 6},/obj/item/flag/ncr,/turf/open/floor/plasteel/f13/stone,/area/f13/ncr)
"XV" = (/obj/structure/chair/bench{dir = 1},/obj/machinery/light/floor,/turf/open/floor/plasteel/f13/stone,/area/f13/ncr)
"Yb" = (/obj/structure/cable{icon_state = "1-2"},/turf/closed/wall/f13/store,/area/f13/wasteland/ncr)
"Yp" = (/obj/structure/chair/stool/f13stool,/turf/open/floor/plasteel/f13/stone,/area/f13/ncr)
"Ys" = (/obj/structure/closet/fridge/meat,/turf/open/floor/plasteel/f13/stone,/area/f13/ncr)
"Zd" = (/obj/effect/landmark/start/f13/ncrmedofficer,/turf/open/floor/plasteel/f13/stone,/area/f13/ncr_main)
"ZD" = (/obj/effect/landmark/start/f13/ncrdrillsergeant,/turf/open/floor/plasteel/f13/stone,/area/f13/ncr_main)
"ZH" = (/obj/machinery/bloodbankgen,/turf/open/floor/plasteel/f13/stone,/area/f13/ncr)
"ZZ" = (/turf/closed/wall/f13/store,/area/f13/ncr)

(1,1,1) = {"
zMzMzMiAiAiAiAiAiAzMzMzMzMzMjyjyjyjyjyjyjyjyjyjyjyjyjyjyjyjyjyjyjyjyjyjyjyjyUaUaUaUaUaUaUaUaUaUaUaUaUaUaUaUaUaUaUaUaUaUa
QrnqnqkcVbxyxyVbxynqnqnqnqnqDVyNLCRLRLUoObBrLCObObxItHiwObObObDVObObObObObDVApApKLKLKLKLKLKLKLKLKLKLKLKLKLKLKLRcbhKWKWKW
QrnqnqkcVbxyxyVbxynqnqnqnqnqxIObObObObObObObObObObxItHObObObObDVObObObObObDVApApKLKLKLKLKLKLKLKLKLKLlilililipgRcbhKWgoKW
QrnqnqkcVbxyxyVbxynqGPnqnqnqxIObpuntAgJbObQcQcnbObDVgKObObObAbDVgKObObObAbDVApApKLKLKLKLKLKLKLKLKLKLOlBEeHliKLRcbhKWKWKW
QrnqnqkcVbxyxyVbxynqnqnqnqxvDVgKObmwObObObObObObObDVObObgsObObDVObObZdObObDVApApKLKLKLKLKLKLKLKLKLKLliBEdbliKLRcbhKWKWKW
QrnqnqkcVbxyxyVbxynqnqnqnqnqFlObIIORZDGDObOpOpemObDVObObJnJnObDVObObJnJnObDVApApKLKLKLKLKLKLKLKLKLKLlilililipgRcbhKWgoKW
QrnqnqkcVbxyxyVbxynqnqnqnqxvDVgKObKDObObObObObObObrvJHDVxIxIDVDVJHDVxIxIDVDVApApKLKLKLKLKLKLKLKLKLKLKLKLKLKLKLRcbhKWKWKW
QrnqnqkcVbxyxyVbxynqGPnqnqnqxIObMlcOhpChswWDOWOWswswswDQObObObObObObObObObDVApApKLKLKLKLKLKLKLKLKLKLlilililipgRcbhKWKWKW
QrnqnqkcVbxyxyVbxynqnqnqnqnqxIObObKDObObObObObObAbDVDVDVDVDVDVDVJHDVxIxIDVDVApApKLKLKLKLKLKLKLKLKLKLOlBEwgliKLRcbhKWgoKW
QrnqnqkcVbxyxyVbxynqnqnqnqxvDVgKAfxTxuifObQcTcQcObxItHObObObObDVObObakakObDVApApKLKLKLKLKLKLKLKLKLKLlidbBEliKLRcbhKWKWKW
QrnqnqkcVbxyxyVbxynqGPnqnqnqxIObObKDObObObObObObObxItHObhtObAbDVObObObObAbDVApApKLKLKLKLKLKLKLKLKLKLlilililipgRcbhKWKWKW
QrnqnqkcVbxyxyVbxynqnqnqnqnqxIObObyfHpHpObQcQcQcAbDVObObObObObDVObObObObObDVApApKLKLKLKLKLKLKLKLKLKLKLKLKLKLKLRcbhKWgoKW
QrnqnqisVblclcVblcnqnqnqnqxvDVyNObfSObObObObObObObJHJnJnnCJnJnDVJnJnnCJnJnDVApApKLKLKLKLKLKLKLKLKLKLlilililipgRcbhKWKWKW
QrnqnqjdGPjdjdGPjdnqnqGQjRjRAAlDlDpUxIxIlqFlksxIxIgnxIxIDVxIxIDVxIxIDVxIxIDVApApKLKLKLKLKLKLKLKLKLKLOlBEwgliKLRcbhKWKWKW
QrnqnqnqnqnqnqnqnqnqnqYbApApApApApxGApApApApApApApApApApxGApApApApApApApApApWmApKLKLKLKLKLKLKLKLKLKLliBEdbliKLRcbhKWgoKW
QrnqnqnqnqnqnqnqnqnqnqYbApApApApApApApApWmApWmApApApApApApApApApApApApApApApApApKLKLKLKLKLKLKLKLKLKLlilililipgRcbhKWKWKW
QrZZZZZZZZZZZZZZZZZZLuIpApApKLKLKLKLKLKLKLKLKLKLKLKLKLKLKLKLKLKLKLKLKLKLKLKLKLKLKLKLKLKLKLKLKLKLKLKLKLKLKLKLKLRcbhKWKWKW
UaZZDLqcDLVFDLVFqcDLOuZZCjApKLKLKLKLKLKLKLKLKLKLKLKLKLKLKLKLKLKLKLKLKLKLKLKLKLKLKLKLKLKLKLKLKLKLKLKLlilililipgRcbhKWgoKW
UaZZkyDLDLDLDLDLDLDLamZZApApKLKLKLKLKLKLKLKLKLKLKLKLKLKLKLKLKLKLKLKLKLKLKLKLKLKLKLKLKLKLKLKLKLKLKLKLOlBEVZliKLRcbhKWKWKW
UaZZJcWOcKaCcKaCcKXCJcZZApApKLKLKLKLKLKLKLKLKLKLKLKLKLKLKLKLKLKLKLKLKLKLKLKLKLKLKLKLKLKLKLKLKLKLKLKLliBEeHliKLRcbhKWKWKW
UaZZDLDLDLDLDLDLDLDLDLZZWmApKLKLKLKLKLKLKLKLKLKLKLKLKLKLKLKLKLKLKLKLKLKLKLKLKLKLKLKLKLKLKLKLKLKLKLKLlilililipgRcbhKWgoKW
UaZZkymBmBmBDLmBmBmBamZZApApKLKLKLKLKLKLKLKLKLKLKLKLKLKLKLKLKLKLKLKLKLKLKLKLKLKLKLKLKLKLKLKLKLKLKLKLKLKLKLKLKLRcbhKWKWKW
UaZZDLDLDLDLDLDLDLDLDLlIApApKLKLKLKLKLKLKLKLKLKLKLKLKLKLKLKLKLKLKLKLKLKLKLKLKLKLKLKLKLKLKLKLKLKLKLKLlilililipgRcbhKWKWKW
UaZZkymBmBXVDLXVmBmBamZZApApKLKLKLKLKLKLKLKLKLKLKLKLKLKLKLKLKLKLKLKLKLKLKLKLKLKLKLKLKLKLKLKLKLKLKLKLOlBEwgliKLRcbhKWgoKW
UaZZDLDLDLDLDLDLDLDLDLZZWmApKLKLKLKLKLKLKLKLKLKLKLKLKLKLKLKLKLKLKLKLKLKLKLKLKLKLKLKLKLKLKLKLKLKLKLKLliBEdbliKLRcbhKWKWKW
UaZZkymBmBmBDLmBmBmBamZZApApliliOlliKLliOlliliKLliOlliliKLliliOlliKLliOlliliKLliliOlliKLKLKLKLKLKLKLlilililipgRcbhKWKWKW
UaZZDLDLDLEmDLEmDLDLDLZZCjApliBEBEliKLliBEBEliKLliBEBEliKLliBEBEliKLliBEBEliKLliBEBEliKLKLKLKLKLKLKLKLKLKLKLKLRcbhKWgoKW
UaZZkyIbDLDLDLDLDLIbamZZApApliCeeHliKLlioGdbliKLliCeeHliKLliCeeHliKLlioGdbliKLlioGdbliKLKLKLKLKLKLKLKLKLKLKLKLRcbhKWKWKW
UaZZDLDLjIDLDLDLjIDLDLZZApAplilililiKLlilililiKLlilililiKLlilililiKLlilililiKLlilililiKLKLKLKLKLKLKLKLKLKLKLKLRcbhKWKWKW
UaZZZZZZZZZZZZZZZZZZZZZZApApApApApApApApApApApApApApApApApApApApApApApApApApApApApApApApApApApApKLKLKLKLKLKLKLRcbhKWgoKW
UaKWKWenKWKWKWKWKWKWKWZZApApApApApApApApApApWmApApWmApApApApApApApApApApApApIWApApIWApApIWApApApKLQwKLKLKLKLQwRcbhKWKWKW
UaXyXyZZZZZZZZZZZZZZZZZZRRRRZZZZRRRRZZZZRRRRZZlIlIZZZZRRRRZZRRRRZZRRRRZZRRRRZZZZZZZZZZZZZZZZDAwZwZwZwZDvwZwZwZwZwZKWKWKW
UaKWKWZZrdILDLZZkyZZDLDLDLDLDLVFDLDLDLVFDLDLDLDLDLDLVFDLDLVFDLDLVFDLDLVFDLDLVFDLDLDLDLDLDLlICBDADvDvBLDvBLDvDvOcKWKWKWKW
UaKWKWZZGLYpDLHnDLZZkyDLDLsmsmDLDLDLDLUmUmUmUmDLDLOQOQOQOQDLDLEcPuPuPuDLPuPuPuDLDLDLDLjIDLZZDAwZDvDvDvDvDvDvDvOcKWKWKWKW
UaKWKWZZcNriDLZZDLHnDLDLjIDLjIDLDLDLDLDLDLDLDLDLDLDLDLDLDLDLDLDLUjUjUjDLUjUjUjDLZZlIZZZZZZZZKWOcDvDvDvDvDvDvDvJRKWKWKWKW
UaKWKWZZLpjIDLZZkyZZDLZZZZZZZZZZZZdqZZZZZZZZZZZZZZZZZZZZZZZZZZDLmBmBmBDLmBmBmBDLZZDLDLDLDLynKWOcDvDvDvDvDvDvDvOcKWKWKWKW
UaKWKWZZZZZZZZZZDLZZkylIAZeuOPZZDLDLDLVFyCyCfdyCyCfdyCDLVFDLZZkyDLDLDLDLDLDLDLamZZkyDLDLDLynKWOcDvDvDvDvDvDvDvOcKWKWKWKW
UaKWKWZZuMVFoVDLDLZZDLZZDLDLiDZZDLDLDLDLDLDLDLDLDLDLDLPuPuPuZZDLPuPuPuDLPuPuPuDLZZDLDLDLDLynKWOcDvDvDvDvDvDvDvOcKWKWKWKW
UaKWKWZZRYDLDLDLNJZZDLZZHwZZZZZZDLDLDLDLDLDLDLDLDLDLDLUjUjJzZZDLUjUjUjDLUjUjUjDLZZkyDLDLDLynKWOcDvDvDvDvDvDvDvOcKWKWKWKW
UaKWKWZZKsDLDLDLaBZZkyZZDLlIcdZZDLDLDLDLDLDLlWlWDLDLDLmBmBmBZZDLmBmBmBDLmBmBmBDLZZDLDLDLDLZZKWJRDvDvDvDvDvDvDvJRKWKWKWKW
UaKWKWZZRYDLDLDLNJZZDLZZZZZZZZZZZZZZDLDLDLDLDLDLDLDLDLDLDLamZZkyDLDLDLDLDLDLDLamZZkyDLDLDLynKWOcDvDvDvDvDvDvDvOcKWKWKWKW
UaKWKWZZKsDLDLDLaBZZkyZZSKZZSKZZSKZZdqyqyqdqyqyqdqyqyqdqyqyqZZDLUjUjUjUjUjUjmRufZZDLDLDLDLynKWOcDvDvDvDvDvDvDvOcKWKWKWKW
UaKWKWZZRYDLDLDLNJZZDLZZlIZZlIZZlIZZDLDLyqDLDLyqDLDLyqDLDLyqZZDLDLDLDLDLDLDLDLDLZZkyDLDLDLynKWOcDvDvDvDvDvDvDvOcKWKWKWKW
UaKWKWZZRPjIZHODDLZZDLlIDLAZDLAZrjZZkmlPyqkmCFyqkmCFyqkmCFyqZZghWQYsTATGTGIigGIcZZDLDLDLDLynKWOcDvDvDvDvDvDvDvOcKWKWKWKW
UaXyXyZZZZZZZZZZZZZZZZZZZZZZZZZZZZZZZZZZZZZZZZZZZZZZZZZZZZZZZZZZZZZZZZZZZZZZZZZZZZynynynynZZKWJRDvDvDvDvDvDvDvJRKWKWKWKW
UaKWKWKWKWKWKWKWKWKWKWKWKWKWKWKWKWKWKWKWKWKWKWKWKWKWKWKWKWKWKWKWKWKWKWKWKWKWKWKWKWKWKWKWKWKWKWOcDvDvDvDvDvDvDvOcKWKWKWKW
UaKWKWKWKWKWKWKWKWKWKWKWKWKWKWKWKWKWKWKWKWKWKWKWKWKWKWKWKWKWKWKWKWKWKWKWKWKWKWKWgoKWKWKWKWgoKWOcDvDvDvDvDvDvDvOcKWKWKWKW
UaKWKWKWKWKWKWKWKWKWKWKWKWKWKWKWKWKWKWKWKWKWKWKWKWKWKWKWKWKWKWKWKWKWKWKWKWKWKWKWKWKWKWKWKWKWKWOcDvDvDvDvDvDvDvOcKWKWKWKW
UaKWKWKWKWKWKWKWKWKWKWKWKWKWKWKWKWKWKWKWKWKWKWKWKWKWKWKWKWKWKWKWKWKWKWKWKWKWKWKWKWKWKWKWKWKWKWOcDvDvDvDvDvDvDvOcKWKWKWKW
UaKWKWKWKWKWKWKWKWKWKWKWKWKWKWKWKWKWKWKWKWKWKWKWKWKWKWKWKWKWKWKWKWKWKWKWKWKWKWKWKWKWKWKWKWKWKWOcDvDvDvDvDvDvDvOcKWKWKWKW
UaKWKWKWKWKWKWKWKWKWKWKWKWKWKWKWKWKWKWKWKWKWKWKWKWKWKWKWKWKWKWKWKWKWKWKWKWKWKWKWKWKWKWKWKWKWKWJRDvDvDvDvDvDvDvJRKWKWKWKW
UaKWKWKWKWKWKWKWKWKWKWKWKWKWKWKWKWKWKWKWKWKWKWKWKWKWKWKWKWKWKWKWKWKWKWKWKWKWKWKWKWKWKWKWKWKWKWOcDvDvDvDvDvDvDvOcKWKWKWKW
UaKWKWKWKWKWKWKWKWKWKWKWKWKWKWKWKWKWKWKWKWKWKWKWKWKWKWKWKWKWKWKWKWKWKWKWKWKWKWKWKWKWKWKWKWKWKWOcDvDvDvDvDvDvDvOcKWKWKWKW
UaKWKWKWKWKWKWKWKWKWKWKWKWKWKWKWKWKWKWKWKWKWKWKWKWKWKWKWKWKWKWKWKWKWKWKWKWKWKWKWKWKWKWKWKWKWKWOcDvDvDvDvDvDvDvOcKWKWKWKW
UaKWKWKWKWKWKWKWKWKWKWKWKWKWKWKWKWKWKWKWKWKWKWKWKWKWKWKWKWKWKWKWKWKWKWKWKWKWKWKWKWKWKWKWKWKWKWOcDvDvDvDvDvDvDvOcKWKWKWKW
UaKWKWKWKWKWKWKWKWKWKWKWKWKWKWKWKWKWKWKWKWKWKWKWKWKWKWKWKWKWKWKWKWKWKWKWKWKWKWKWKWKWKWKWKWKWKWJRDvDvDvDvDvDvDvJRKWKWKWKW
UaKWKWKWKWKWKWKWKWKWKWKWKWKWKWKWKWKWKWKWKWKWKWKWKWKWKWKWKWKWKWKWKWKWKWKWKWKWKWKWKWKWKWKWKWKWKWOcDvDvDvDvDvDvDvOcKWKWKWKW
UaKWKWKWKWKWKWKWKWKWKWKWKWKWKWKWKWKWKWKWKWKWKWKWKWKWKWKWKWKWKWKWKWKWKWKWKWKWKWKWKWKWKWKWKWKWKWOcDvDvDvDvDvDvDvOcKWKWKWKW
UaKWKWKWKWKWKWKWKWKWKWKWKWKWKWKWKWKWKWKWKWKWKWKWKWKWKWKWKWKWKWKWKWKWKWKWKWKWKWKWKWKWKWKWKWKWKWOcDvDvDvDvDvDvDvOcKWKWKWKW
UaKWKWKWKWKWKWKWKWKWKWKWKWKWKWKWKWKWKWKWKWKWKWKWKWKWKWKWKWKWKWKWKWKWKWKWKWKWKWKWKWKWKWKWKWKWKWOcDvDvDvDvDvDvDvOcKWKWKWKW
"}
