"aI" = (/obj/structure/shelf_wood,/obj/item/twohanded/spear/bonespear,/turf/open/indestructible/ground/outside/desert,/area/f13/wasteland)
"aT" = (/obj/machinery/hydroponics/soil,/obj/effect/overlay/desert_side,/turf/open/indestructible/ground/outside/dirt,/area/f13/wasteland)
"bB" = (/obj/machinery/hydroponics/soil,/turf/open/indestructible/ground/outside/dirt,/area/f13/wasteland)
"bH" = (/turf/open/indestructible/ground/inside/dirt,/area/f13/tribe)
"cf" = (/obj/effect/overlay/desert_side,/obj/effect/overlay/desert_side{dir = 8},/turf/open/indestructible/ground/outside/dirt,/area/f13/wasteland)
"cz" = (/turf/open/indestructible/ground/outside/desert,/area/f13/wasteland)
"cQ" = (/obj/effect/overlay/desert_side{dir = 8},/obj/effect/overlay/desert_side{dir = 4},/turf/open/indestructible/ground/outside/dirt,/area/f13/wasteland)
"cR" = (/obj/structure/shelf_wood,/obj/item/clothing/suit/armor/medium/tribal/tribe_heavy_armor,/turf/open/indestructible/ground/inside/dirt,/area/f13/tribe)
"dm" = (/obj/structure/closet/crate/wooden,/obj/item/seeds/apple,/obj/item/seeds/apple,/obj/item/seeds/bamboo,/obj/item/seeds/banana,/obj/item/seeds/berry,/obj/item/seeds/corn,/obj/item/seeds/garlic,/obj/item/seeds/herbs,/obj/item/seeds/onion,/obj/item/seeds/onion,/obj/item/seeds/peach,/obj/item/seeds/poppy,/obj/item/seeds/tomato,/obj/item/seeds/wheat,/turf/open/indestructible/ground/outside/desert,/area/f13/wasteland)
"dQ" = (/obj/effect/overlay/desert_side{dir = 4},/obj/effect/overlay/desert_side{dir = 1},/turf/open/indestructible/ground/outside/dirt,/area/f13/wasteland)
"ed" = (/obj/structure/destructible/tribal_torch/wall/lit,/turf/open/indestructible/ground/outside/dirt,/area/f13/wasteland)
"eN" = (/obj/structure/furnace,/obj/effect/overlay/desert_side{dir = 1},/turf/open/indestructible/ground/outside/dirt,/area/f13/wasteland)
"eQ" = (/obj/machinery/workbench,/obj/effect/overlay/desert_side{dir = 8},/obj/effect/overlay/desert_side,/turf/open/indestructible/ground/outside/dirt,/area/f13/wasteland)
"ff" = (/obj/structure/flora/tree/joshua,/turf/open/indestructible/ground/outside/desert,/area/f13/wasteland)
"gh" = (/obj/structure/table/wood,/obj/item/melee/smith/hammer/premade,/obj/effect/overlay/desert_side{dir = 4},/obj/effect/overlay/desert_side,/turf/open/indestructible/ground/outside/dirt,/area/f13/wasteland)
"ha" = (/obj/machinery/hydroponics/soil,/obj/effect/overlay/desert_side{dir = 4},/turf/open/indestructible/ground/outside/dirt,/area/f13/wasteland)
"hR" = (/obj/structure/chair/wood/wings,/turf/open/indestructible/ground/outside/desert,/area/f13/wasteland)
"hV" = (/obj/structure/chair/wood/wings{dir = 1},/turf/open/indestructible/ground/outside/desert,/area/f13/wasteland)
"jn" = (/obj/structure/destructible/tribal_torch/wall/lit{dir = 8},/obj/structure/dresser,/turf/open/indestructible/ground/inside/dirt,/area/f13/tribe)
"jw" = (/obj/structure/flora/tree/cactus,/turf/open/indestructible/ground/outside/desert,/area/f13/wasteland)
"kj" = (/obj/structure/anvil/obtainable/table,/obj/effect/overlay/desert_side{dir = 1},/turf/open/indestructible/ground/outside/dirt,/area/f13/wasteland)
"kF" = (/obj/effect/overlay/desert_side,/obj/effect/overlay/desert_side{dir = 1},/turf/open/indestructible/ground/outside/dirt,/area/f13/wasteland)
"ms" = (/obj/item/reagent_containers/glass/rag,/turf/open/indestructible/ground/outside/dirthole,/area/f13/tribe)
"mu" = (/obj/structure/flora/tree/wasteland,/turf/open/indestructible/ground/outside/desert,/area/f13/wasteland)
"ng" = (/turf/closed/wall/f13/tentwall,/area/f13/tribe)
"nw" = (/obj/structure/flora/tree/cactus_alt,/turf/open/indestructible/ground/outside/desert,/area/f13/wasteland)
"nO" = (/obj/structure/simple_door/tent,/turf/open/indestructible/ground/outside/desert,/area/f13/tribe)
"pq" = (/obj/structure/shelf_wood,/obj/item/clothing/under/f13/tribe,/obj/item/clothing/suit/armor/light/tribal/wastetribe,/turf/open/indestructible/ground/inside/dirt,/area/f13/tribe)
"rf" = (/obj/structure/table/wood,/turf/open/indestructible/ground/inside/dirt,/area/f13/tribe)
"sp" = (/obj/effect/overlay/desert_side{dir = 8},/obj/effect/overlay/desert_side,/turf/open/indestructible/ground/outside/dirt,/area/f13/wasteland)
"uv" = (/obj/structure/destructible/tribal_torch/lit,/turf/open/indestructible/ground/outside/desert,/area/f13/wasteland)
"vk" = (/obj/structure/chair/wood/wings{dir = 4},/turf/open/indestructible/ground/outside/desert,/area/f13/wasteland)
"vm" = (/obj/structure/destructible/tribal_torch/wall/lit,/obj/effect/overlay/desert_side{dir = 8},/turf/open/indestructible/ground/outside/dirt,/area/f13/wasteland)
"xY" = (/obj/effect/overlay/desert_side{dir = 1},/turf/open/indestructible/ground/outside/dirt,/area/f13/wasteland)
"yb" = (/obj/effect/overlay/desert_side{dir = 1},/obj/effect/overlay/desert_side,/turf/open/indestructible/ground/outside/dirt,/area/f13/wasteland)
"zf" = (/obj/structure/simple_door/tent,/turf/open/indestructible/ground/inside/dirt,/area/f13/tribe)
"At" = (/obj/structure/chair/wood/wings{dir = 8},/turf/open/indestructible/ground/outside/desert,/area/f13/wasteland)
"AE" = (/obj/structure/destructible/tribal_torch/lit,/obj/effect/overlay/desert_side,/turf/open/indestructible/ground/outside/dirt,/area/f13/wasteland)
"Bi" = (/obj/machinery/hydroponics/soil,/obj/effect/overlay/desert_side{dir = 8},/obj/effect/overlay/desert_side,/turf/open/indestructible/ground/outside/dirt,/area/f13/wasteland)
"Bm" = (/turf/open/indestructible/ground/outside/dirt,/area/f13/wasteland)
"BS" = (/obj/structure/bed/mattress,/turf/open/indestructible/ground/inside/dirt,/area/f13/tribe)
"Cw" = (/obj/structure/sink/well,/turf/open/indestructible/ground/outside/dirt,/area/f13/wasteland)
"Ds" = (/obj/effect/overlay/desert_side{dir = 4},/turf/open/indestructible/ground/outside/dirt,/area/f13/wasteland)
"Ej" = (/obj/item/cultivator/rake,/obj/item/hatchet,/obj/item/reagent_containers/glass/bucket/wood,/obj/item/reagent_containers/glass/bucket/wood,/turf/open/indestructible/ground/outside/desert,/area/f13/wasteland)
"Es" = (/obj/effect/overlay/desert_side{dir = 8},/turf/open/indestructible/ground/outside/dirt,/area/f13/wasteland)
"Fc" = (/obj/structure/destructible/tribal_torch/wall/lit,/turf/open/indestructible/ground/inside/dirt,/area/f13/tribe)
"Gg" = (/obj/structure/table/wood,/obj/effect/overlay/desert_side{dir = 4},/obj/effect/overlay/desert_side{dir = 1},/turf/open/indestructible/ground/outside/dirt,/area/f13/wasteland)
"Gt" = (/obj/machinery/hydroponics/soil,/obj/effect/overlay/desert_side{dir = 4},/obj/effect/overlay/desert_side,/turf/open/indestructible/ground/outside/dirt,/area/f13/wasteland)
"GE" = (/obj/structure/table/wood,/obj/effect/overlay/desert_side{dir = 8},/obj/effect/overlay/desert_side{dir = 1},/turf/open/indestructible/ground/outside/dirt,/area/f13/wasteland)
"JP" = (/obj/effect/overlay/desert_side{dir = 4},/obj/effect/overlay/desert_side{dir = 8},/turf/open/indestructible/ground/outside/dirt,/area/f13/wasteland)
"Kv" = (/obj/structure/campfire,/turf/open/indestructible/ground/outside/dirt,/area/f13/wasteland)
"Ky" = (/obj/effect/overlay/desert_side,/turf/open/indestructible/ground/outside/dirt,/area/f13/wasteland)
"Lq" = (/obj/machinery/hydroponics/soil,/obj/effect/overlay/desert_side{dir = 8},/obj/effect/overlay/desert_side{dir = 1},/turf/open/indestructible/ground/outside/dirt,/area/f13/wasteland)
"LW" = (/obj/structure/destructible/tribal_torch/wall/lit{dir = 8},/turf/open/indestructible/ground/inside/dirt,/area/f13/tribe)
"Mv" = (/obj/effect/overlay/desert_side{dir = 1},/obj/effect/overlay/desert_side{dir = 4},/turf/open/indestructible/ground/outside/dirt,/area/f13/wasteland)
"NA" = (/obj/structure/fermenting_barrel,/turf/open/indestructible/ground/outside/desert,/area/f13/wasteland)
"Rs" = (/obj/structure/shelf_wood,/obj/item/clothing/suit/armor/light/tribal/wastetribe,/turf/open/indestructible/ground/inside/dirt,/area/f13/tribe)
"SO" = (/obj/machinery/hydroponics/soil,/obj/effect/overlay/desert_side{dir = 8},/turf/open/indestructible/ground/outside/dirt,/area/f13/wasteland)
"SP" = (/obj/effect/overlay/desert_side{dir = 1},/obj/effect/overlay/desert_side{dir = 8},/turf/open/indestructible/ground/outside/dirt,/area/f13/wasteland)
"TP" = (/obj/machinery/hydroponics/soil,/obj/effect/overlay/desert_side{dir = 4},/obj/effect/overlay/desert_side{dir = 1},/turf/open/indestructible/ground/outside/dirt,/area/f13/wasteland)
"Ux" = (/obj/structure/campfire/stove,/turf/open/indestructible/ground/inside/dirt,/area/f13/tribe)
"WE" = (/obj/structure/table/wood,/obj/machinery/processor/chopping_block,/turf/open/indestructible/ground/inside/dirt,/area/f13/tribe)
"WR" = (/obj/effect/overlay/desert_side,/obj/effect/overlay/desert_side{dir = 4},/turf/open/indestructible/ground/outside/dirt,/area/f13/wasteland)
"WZ" = (/obj/machinery/smartfridge/bottlerack/seedbin/primitive,/turf/open/indestructible/ground/outside/desert,/area/f13/wasteland)
"Xq" = (/obj/structure/closet/crate/wooden,/obj/item/seeds/cabbage,/obj/item/seeds/carrot,/obj/item/seeds/cannabis,/obj/item/seeds/cherry,/obj/item/seeds/eggplant,/obj/item/seeds/grape,/obj/item/seeds/lemon,/obj/item/seeds/orange,/obj/item/seeds/peas,/obj/item/seeds/pineapple,/obj/item/seeds/poppy/broc,/obj/item/seeds/potato,/obj/item/seeds/potato,/obj/item/seeds/sunflower,/obj/item/seeds/tea,/obj/item/seeds/xander,/obj/item/seeds/yucca,/turf/open/indestructible/ground/outside/desert,/area/f13/wasteland)
"Xx" = (/obj/machinery/hydroponics/soil,/obj/effect/overlay/desert_side{dir = 1},/turf/open/indestructible/ground/outside/dirt,/area/f13/wasteland)
"YE" = (/obj/structure/destructible/tribal_torch/wall/lit{dir = 4},/turf/open/indestructible/ground/inside/dirt,/area/f13/tribe)

(1,1,1) = {"
czczczczczczczczczczczczczczczczczczczczczczczczczczczczczczczczczczcz
czczczczczczczczczczczczczczczczczczczczczczczczczczczczczczczczczczcz
czczczczczczczczczczczczczczczczczczczczczczczczczczczczczczczczczczcz
czczczczczczczczczczczczczczczczczczczczczczczczczczczczczczczczczczcz
czczczczczczczczczczczczczczczczczczczczczczczczczczczczczczczczczczcz
czczczczczczczczczczczczczczczczczczczczczczczczczczczczczczczczczczcz
czczczczczczczczczczczczczczczczczczczczczczczczczczczczczczczczczczcz
czczczczczczczczczczczczczczffczczuvczNAczczczczczuvczczczczczczczczcz
czczczmuczczczczcznwczczczczczczczczczLqXxxYXxTPczczczczczczczczczczcz
czczczczczczczczczczczczczczczczczczczSObBBmbBhaczczczczczczczczczczcz
czczczczcznwczczczczczczczczczczczczczSObBBmbBhaczczczczczczczczczczcz
czcznwczczczczczczczczngngngngngcznwczSObBBmbBhaczczcznwczczczczczczcz
czczczczczczczczczmuczngjnbHBSngczczczSObBBmbBhaczczczczczczczczczczcz
czczczczczGEeNkjGgczczngbHbHBSngczczczSObBBmbBhaczczczczczffczczczczcz
czczczczczeQBmBmghczczngngzfngngczczczBiaTBmaTGtczczczczczczczczczczcz
czczuvczczczEsBmczuvczczczcQczczczuvczEjWZJPdmXqczuvczczczczczczczczcz
czczczczczczcfKyybybybxYxYBmxYxYybybxYxYxYDsczczczczczczmuczczczczczcz
czczczhRhRhRczczczczczEsBmBmBmDsczaIngngngngngngngczczczczczczczczczcz
czczvkSPxYMvAtczczczczEsBmCwBmDsczaIngLWRsbHpqYEngczczczczczczczczczcz
czczvkEsKvBmybybybybybBmBmBmBmBmybkFzfbHbHbHbHbHngczngngngczczczczczcz
czczvkspKyWRAtczczczczEsBmBmBmDsczaIngLWcRbHpqYEngczngmsngczczczczczcz
czczczhVczhVczczczczczspBmBmBmDsczaIngngngngngngngczngnOngczczczczczcz
czczczczczczczczmuczczczEsBmBmBmxYBmBmBmBmBmBmBmBmxYBmDsczczczczczczcz
czczuvczczczczczczuvczczvmBmedBmBmAEKyBmBmBmBmBmBmBmBmBmxYdQczczczuvcz
czczczczczczczczczczngngngzfngngngczczngngzfngngngzfngngngzfngngczczcz
czczczczczffczczczczngLWbHbHbHYEngczczngBSbHBSngBSbHBSngBSbHBSngczczcz
czczczczczczczczczczngbHbHbHbHbHngczczngbHbHYEngbHbHYEngbHbHYEngczczcz
czczczcznwczczczjwczngbHbHrfrfWEngczczngBSbHBSngBSbHBSngBSbHBSngczczcz
czczczczczczczczczczngbHbHFcbHUxngczczngngngngngngngngngngngngngczczcz
czczczczczczczczczczngngngngngngngczczczczczczczczczczczczczczczczczcz
czczczczczczczczczczczczczczczczczczczczczczczczczczczczczczczczczczcz
czczczczczczczczczczczczczczczczczczczczczczczczczczczczczczczczczczcz
czczczczczczczczczczczczczczczczczczczczczczczczczczczczczczczczczczcz
czczczczczczczczczczczczczczczczczczczczczczczczczczczczczczczczczczcz
czczczczczczczczczczczczczczczczczczczczczczczczczczczczczczczczczczcz
"}
