"ap" = (/obj/effect/overlay/desert_side{dir = 1},/obj/effect/overlay/desert_side{dir = 4},/turf/open/indestructible/ground/outside/dirt,/area/f13/wasteland)
"as" = (/turf/closed/wall/f13/tentwall,/area/f13/tribe)
"bc" = (/obj/structure/destructible/tribal_torch/wall/lit{dir = 8},/turf/open/indestructible/ground/inside/dirt,/area/f13/tribe)
"co" = (/obj/structure/shelf_wood,/obj/item/clothing/under/f13/tribe,/obj/item/clothing/suit/armor/light/tribal/wastetribe,/turf/open/indestructible/ground/inside/dirt,/area/f13/tribe)
"eo" = (/obj/machinery/smartfridge/bottlerack/seedbin/primitive,/turf/open/indestructible/ground/outside/desert,/area/f13/wasteland)
"ez" = (/obj/structure/fermenting_barrel,/turf/open/indestructible/ground/outside/desert,/area/f13/wasteland)
"eT" = (/obj/structure/destructible/tribal_torch/wall/lit{dir = 8},/obj/structure/dresser,/turf/open/indestructible/ground/inside/dirt,/area/f13/tribe)
"fT" = (/turf/open/indestructible/ground/outside/dirt,/area/f13/wasteland)
"ga" = (/obj/structure/chair/wood/wings,/turf/open/indestructible/ground/outside/desert,/area/f13/wasteland)
"ha" = (/obj/structure/destructible/tribal_torch/wall/lit,/turf/open/indestructible/ground/outside/dirt,/area/f13/wasteland)
"ih" = (/obj/structure/table/wood,/obj/item/melee/smith/hammer/premade,/obj/effect/overlay/desert_side{dir = 4},/obj/effect/overlay/desert_side,/turf/open/indestructible/ground/outside/dirt,/area/f13/wasteland)
"kM" = (/obj/structure/chair/wood/wings{dir = 1},/turf/open/indestructible/ground/outside/desert,/area/f13/wasteland)
"ld" = (/obj/effect/overlay/desert_side{dir = 1},/obj/effect/overlay/desert_side,/turf/open/indestructible/ground/outside/dirt,/area/f13/wasteland)
"lG" = (/obj/machinery/hydroponics/soil,/obj/effect/overlay/desert_side{dir = 8},/obj/effect/overlay/desert_side,/turf/open/indestructible/ground/outside/dirt,/area/f13/wasteland)
"mi" = (/obj/machinery/hydroponics/soil,/obj/effect/overlay/desert_side{dir = 4},/obj/effect/overlay/desert_side{dir = 1},/turf/open/indestructible/ground/outside/dirt,/area/f13/wasteland)
"mo" = (/obj/machinery/hydroponics/soil,/obj/effect/overlay/desert_side{dir = 8},/turf/open/indestructible/ground/outside/dirt,/area/f13/wasteland)
"ns" = (/obj/structure/destructible/tribal_torch/wall/lit,/turf/open/indestructible/ground/inside/dirt,/area/f13/tribe)
"nQ" = (/turf/open/indestructible/ground/outside/desert,/area/f13/wasteland)
"qq" = (/obj/structure/destructible/tribal_torch/wall/lit{dir = 4},/turf/open/indestructible/ground/inside/dirt,/area/f13/tribe)
"rf" = (/obj/machinery/hydroponics/soil,/obj/effect/overlay/desert_side,/turf/open/indestructible/ground/outside/dirt,/area/f13/wasteland)
"sH" = (/obj/structure/chair/wood/wings{dir = 4},/turf/open/indestructible/ground/outside/desert,/area/f13/wasteland)
"sW" = (/obj/machinery/hydroponics/soil,/obj/effect/overlay/desert_side{dir = 4},/turf/open/indestructible/ground/outside/dirt,/area/f13/wasteland)
"sX" = (/obj/machinery/hydroponics/soil,/obj/effect/overlay/desert_side{dir = 8},/obj/effect/overlay/desert_side{dir = 1},/turf/open/indestructible/ground/outside/dirt,/area/f13/wasteland)
"ui" = (/obj/structure/table/wood,/obj/effect/overlay/desert_side{dir = 4},/obj/effect/overlay/desert_side{dir = 1},/turf/open/indestructible/ground/outside/dirt,/area/f13/wasteland)
"us" = (/obj/effect/overlay/desert_side{dir = 1},/turf/open/indestructible/ground/outside/dirt,/area/f13/wasteland)
"wA" = (/obj/structure/closet/crate/wooden,/obj/item/seeds/cabbage,/obj/item/seeds/carrot,/obj/item/seeds/cannabis,/obj/item/seeds/cherry,/obj/item/seeds/eggplant,/obj/item/seeds/grape,/obj/item/seeds/lemon,/obj/item/seeds/orange,/obj/item/seeds/peas,/obj/item/seeds/pineapple,/obj/item/seeds/poppy/broc,/obj/item/seeds/potato,/obj/item/seeds/potato,/obj/item/seeds/sunflower,/obj/item/seeds/tea,/obj/item/seeds/xander,/obj/item/seeds/yucca,/turf/open/indestructible/ground/outside/desert,/area/f13/wasteland)
"wC" = (/obj/effect/overlay/desert_side{dir = 4},/obj/effect/overlay/desert_side{dir = 8},/turf/open/indestructible/ground/outside/dirt,/area/f13/wasteland)
"yy" = (/obj/item/reagent_containers/glass/rag,/turf/open/indestructible/ground/outside/dirthole,/area/f13/tribe)
"zr" = (/obj/structure/destructible/tribal_torch/lit,/obj/effect/overlay/desert_side,/turf/open/indestructible/ground/outside/dirt,/area/f13/wasteland)
"zy" = (/obj/structure/simple_door/tent,/turf/open/indestructible/ground/outside/desert,/area/f13/tribe)
"BL" = (/obj/structure/campfire,/turf/open/indestructible/ground/outside/dirt,/area/f13/wasteland)
"BN" = (/obj/effect/overlay/desert_side,/obj/effect/overlay/desert_side{dir = 4},/turf/open/indestructible/ground/outside/dirt,/area/f13/wasteland)
"DQ" = (/obj/structure/simple_door/tent,/turf/open/indestructible/ground/inside/dirt,/area/f13/tribe)
"EB" = (/obj/structure/table/wood,/obj/effect/overlay/desert_side{dir = 8},/obj/effect/overlay/desert_side{dir = 1},/turf/open/indestructible/ground/outside/dirt,/area/f13/wasteland)
"EK" = (/obj/effect/overlay/desert_side,/obj/effect/overlay/desert_side{dir = 8},/turf/open/indestructible/ground/outside/dirt,/area/f13/wasteland)
"Fv" = (/obj/machinery/workbench,/obj/effect/overlay/desert_side{dir = 8},/obj/effect/overlay/desert_side,/turf/open/indestructible/ground/outside/dirt,/area/f13/wasteland)
"Fy" = (/obj/effect/overlay/desert_side{dir = 8},/obj/effect/overlay/desert_side{dir = 4},/turf/open/indestructible/ground/outside/dirt,/area/f13/wasteland)
"Gb" = (/turf/open/indestructible/ground/inside/dirt,/area/f13/tribe)
"Go" = (/obj/effect/overlay/desert_side{dir = 4},/obj/effect/overlay/desert_side{dir = 1},/turf/open/indestructible/ground/outside/dirt,/area/f13/wasteland)
"GJ" = (/obj/structure/sink/well,/turf/open/indestructible/ground/outside/dirt,/area/f13/wasteland)
"GW" = (/obj/structure/shelf_wood,/obj/item/clothing/suit/armor/medium/tribal/tribe_heavy_armor,/turf/open/indestructible/ground/inside/dirt,/area/f13/tribe)
"Hn" = (/obj/effect/overlay/desert_side,/turf/open/indestructible/ground/outside/dirt,/area/f13/wasteland)
"Ik" = (/obj/effect/overlay/desert_side{dir = 1},/obj/effect/overlay/desert_side{dir = 8},/turf/open/indestructible/ground/outside/dirt,/area/f13/wasteland)
"Ix" = (/obj/machinery/hydroponics/soil,/obj/effect/overlay/desert_side{dir = 1},/turf/open/indestructible/ground/outside/dirt,/area/f13/wasteland)
"IB" = (/obj/structure/campfire/stove,/turf/open/indestructible/ground/inside/dirt,/area/f13/tribe)
"JY" = (/obj/structure/bed/mattress,/turf/open/indestructible/ground/inside/dirt,/area/f13/tribe)
"Kv" = (/obj/effect/overlay/desert_side{dir = 8},/turf/open/indestructible/ground/outside/dirt,/area/f13/wasteland)
"Li" = (/obj/machinery/hydroponics/soil,/obj/effect/overlay/desert_side{dir = 4},/obj/effect/overlay/desert_side,/turf/open/indestructible/ground/outside/dirt,/area/f13/wasteland)
"ML" = (/obj/structure/shelf_wood,/obj/item/clothing/suit/armor/light/tribal/wastetribe,/turf/open/indestructible/ground/inside/dirt,/area/f13/tribe)
"Nk" = (/obj/structure/destructible/tribal_torch/wall/lit,/obj/effect/overlay/desert_side{dir = 8},/turf/open/indestructible/ground/outside/dirt,/area/f13/wasteland)
"NG" = (/obj/structure/destructible/tribal_torch/lit,/turf/open/indestructible/ground/outside/desert,/area/f13/wasteland)
"NR" = (/obj/structure/furnace,/obj/effect/overlay/desert_side{dir = 1},/turf/open/indestructible/ground/outside/dirt,/area/f13/wasteland)
"Px" = (/obj/structure/closet/crate/wooden,/obj/item/seeds/apple,/obj/item/seeds/apple,/obj/item/seeds/bamboo,/obj/item/seeds/banana,/obj/item/seeds/berry,/obj/item/seeds/corn,/obj/item/seeds/garlic,/obj/item/seeds/herbs,/obj/item/seeds/onion,/obj/item/seeds/onion,/obj/item/seeds/peach,/obj/item/seeds/poppy,/obj/item/seeds/tomato,/obj/item/seeds/wheat,/turf/open/indestructible/ground/outside/desert,/area/f13/wasteland)
"QC" = (/obj/item/cultivator/rake,/obj/item/hatchet,/turf/open/indestructible/ground/outside/desert,/area/f13/wasteland)
"RO" = (/obj/structure/table/wood,/obj/machinery/processor/chopping_block,/turf/open/indestructible/ground/inside/dirt,/area/f13/tribe)
"Sl" = (/obj/effect/overlay/desert_side,/obj/effect/overlay/desert_side{dir = 1},/turf/open/indestructible/ground/outside/dirt,/area/f13/wasteland)
"TW" = (/obj/structure/anvil/obtainable/table,/obj/effect/overlay/desert_side{dir = 1},/turf/open/indestructible/ground/outside/dirt,/area/f13/wasteland)
"Vl" = (/obj/structure/chair/wood/wings{dir = 8},/turf/open/indestructible/ground/outside/desert,/area/f13/wasteland)
"WW" = (/obj/structure/table/wood,/turf/open/indestructible/ground/inside/dirt,/area/f13/tribe)
"Xo" = (/obj/structure/shelf_wood,/obj/item/twohanded/spear/bonespear,/turf/open/indestructible/ground/outside/desert,/area/f13/wasteland)
"Yo" = (/obj/effect/overlay/desert_side{dir = 8},/obj/effect/overlay/desert_side,/turf/open/indestructible/ground/outside/dirt,/area/f13/wasteland)
"YD" = (/obj/machinery/hydroponics/soil,/turf/open/indestructible/ground/outside/dirt,/area/f13/wasteland)
"ZJ" = (/obj/effect/overlay/desert_side{dir = 4},/turf/open/indestructible/ground/outside/dirt,/area/f13/wasteland)

(1,1,1) = {"
nQnQnQnQnQnQnQnQnQnQnQnQnQnQnQnQnQnQnQnQnQnQnQnQnQnQnQnQnQnQnQnQnQnQnQ
nQnQnQnQnQnQnQnQnQnQnQnQnQnQnQnQnQnQnQnQnQnQnQnQnQnQnQnQnQnQnQnQnQnQnQ
nQnQnQnQnQnQnQnQnQnQnQnQnQnQnQnQnQnQnQnQnQnQnQnQnQnQnQnQnQnQnQnQnQnQnQ
nQnQnQnQnQnQnQnQnQnQnQnQnQnQnQnQnQnQnQnQnQnQnQnQnQnQnQnQnQnQnQnQnQnQnQ
nQnQnQnQnQnQnQnQnQnQnQnQnQnQnQnQnQnQnQnQnQnQnQnQnQnQnQnQnQnQnQnQnQnQnQ
nQnQnQnQnQnQnQnQnQnQnQnQnQnQnQnQnQnQnQnQnQnQnQnQnQnQnQnQnQnQnQnQnQnQnQ
nQnQnQnQnQnQnQnQnQnQnQnQnQnQnQnQnQnQnQnQnQnQnQnQnQnQnQnQnQnQnQnQnQnQnQ
nQnQnQnQnQnQnQnQnQnQnQnQnQnQnQnQnQNGnQeznQnQnQnQnQNGnQnQnQnQnQnQnQnQnQ
nQnQnQnQnQnQnQnQnQnQnQnQnQnQnQnQnQnQnQsXIxusIxminQnQnQnQnQnQnQnQnQnQnQ
nQnQnQnQnQnQnQnQnQnQnQnQnQnQnQnQnQnQnQmoYDfTYDsWnQnQnQnQnQnQnQnQnQnQnQ
nQnQnQnQnQnQnQnQnQnQnQnQnQnQnQnQnQnQnQmoYDfTYDsWnQnQnQnQnQnQnQnQnQnQnQ
nQnQnQnQnQnQnQnQnQnQnQasasasasasnQnQnQmoYDfTYDsWnQnQnQnQnQnQnQnQnQnQnQ
nQnQnQnQnQnQnQnQnQnQnQaseTGbJYasnQnQnQmoYDfTYDsWnQnQnQnQnQnQnQnQnQnQnQ
nQnQnQnQnQEBNRTWuinQnQasGbGbJYasnQnQnQmoYDfTYDsWnQnQnQnQnQnQnQnQnQnQnQ
nQnQnQnQnQFvfTfTihnQnQasasDQasasnQnQnQlGrffTrfLinQnQnQnQnQnQnQnQnQnQnQ
nQnQNGnQnQnQKvfTnQNGnQnQnQFynQnQnQNGnQQCeowCPxwAnQNGnQnQnQnQnQnQnQnQnQ
nQnQnQnQnQnQEKHnldldldususfTususldldusususZJnQnQnQnQnQnQnQnQnQnQnQnQnQ
nQnQnQgagaganQnQnQnQnQKvfTfTfTZJnQXoasasasasasasasnQnQnQnQnQnQnQnQnQnQ
nQnQsHIkusapVlnQnQnQnQKvfTGJfTZJnQXoasbcMLGbcoqqasnQnQnQnQnQnQnQnQnQnQ
nQnQsHKvBLfTldldldldldfTfTfTfTfTldSlDQGbGbGbGbGbasnQasasasnQnQnQnQnQnQ
nQnQsHYoHnBNVlnQnQnQnQKvfTfTfTZJnQXoasbcGWGbcoqqasnQasyyasnQnQnQnQnQnQ
nQnQnQkMnQkMnQnQnQnQnQYofTfTfTZJnQXoasasasasasasasnQaszyasnQnQnQnQnQnQ
nQnQnQnQnQnQnQnQnQnQnQnQKvfTfTfTusfTfTfTfTfTfTfTfTusfTZJnQnQnQnQnQnQnQ
nQnQNGnQnQnQnQnQnQNGnQnQNkfThafTfTzrHnfTfTfTfTfTfTfTfTfTusGonQnQnQNGnQ
nQnQnQnQnQnQnQnQnQnQasasasDQasasasnQnQasasDQasasasDQasasasDQasasnQnQnQ
nQnQnQnQnQnQnQnQnQnQasbcGbGbGbqqasnQnQasJYGbJYasJYGbJYasJYGbJYasnQnQnQ
nQnQnQnQnQnQnQnQnQnQasGbGbGbGbGbasnQnQasGbGbqqasGbGbqqasGbGbqqasnQnQnQ
nQnQnQnQnQnQnQnQnQnQasGbGbWWWWROasnQnQasJYGbJYasJYGbJYasJYGbJYasnQnQnQ
nQnQnQnQnQnQnQnQnQnQasGbGbnsGbIBasnQnQasasasasasasasasasasasasasnQnQnQ
nQnQnQnQnQnQnQnQnQnQasasasasasasasnQnQnQnQnQnQnQnQnQnQnQnQnQnQnQnQnQnQ
nQnQnQnQnQnQnQnQnQnQnQnQnQnQnQnQnQnQnQnQnQnQnQnQnQnQnQnQnQnQnQnQnQnQnQ
nQnQnQnQnQnQnQnQnQnQnQnQnQnQnQnQnQnQnQnQnQnQnQnQnQnQnQnQnQnQnQnQnQnQnQ
nQnQnQnQnQnQnQnQnQnQnQnQnQnQnQnQnQnQnQnQnQnQnQnQnQnQnQnQnQnQnQnQnQnQnQ
nQnQnQnQnQnQnQnQnQnQnQnQnQnQnQnQnQnQnQnQnQnQnQnQnQnQnQnQnQnQnQnQnQnQnQ
nQnQnQnQnQnQnQnQnQnQnQnQnQnQnQnQnQnQnQnQnQnQnQnQnQnQnQnQnQnQnQnQnQnQnQ
"}
