"a" = (/turf/open/indestructible/ground/outside/desert,/area/f13/wasteland)
"c" = (/obj/effect/spawner/structure/window/reinforced,/obj/machinery/door/poddoor/shutters/old{id = "245"},/turf/open/floor/plasteel/f13/vault_floor/floor,/area/f13/vault)
"f" = (/obj/machinery/holopad,/turf/open/indestructible/ground/outside/road,/area/f13/vault)
"g" = (/turf/open/floor/plating/f13/outside/road/harsh{dir = 1},/area/f13/wasteland)
"h" = (/obj/structure/shelf_wood,/obj/machinery/light{dir = 1},/turf/open/floor/plasteel/f13/vault_floor/floor,/area/f13/vault)
"m" = (/turf/open/floor/plasteel/f13/vault_floor/floor,/area/f13/vault)
"r" = (/obj/item/radio/intercom{frequency = 1361; name = "Vault Intercom"; pixel_x = 32},/turf/open/floor/plating/f13/outside/road/harsh,/area/f13/wasteland)
"s" = (/obj/machinery/holopad,/turf/open/floor/plasteel/f13/vault_floor/floor,/area/f13/vault)
"u" = (/obj/structure/shelf_wood,/obj/machinery/light{dir = 4},/turf/open/floor/plasteel/f13/vault_floor/floor,/area/f13/vault)
"v" = (/obj/structure/shelf_wood,/turf/open/floor/plasteel/f13/vault_floor/floor,/area/f13/vault)
"w" = (/turf/open/floor/plating/f13/outside/road/harsh,/area/f13/wasteland)
"z" = (/obj/machinery/light/floor,/turf/open/floor/plasteel/f13/vault_floor/floor,/area/f13/vault)
"C" = (/obj/machinery/button{id = "245"; name = "lockdown"},/turf/closed/wall/r_wall/f13vault{icon_state = "2-i"},/area/f13/vault)
"D" = (/turf/closed/wall/r_wall/f13vault{icon_state = "2-i"},/area/f13/vault)
"E" = (/turf/open/indestructible/ground/outside/road,/area/f13/wasteland)
"F" = (/obj/structure/table/reinforced,/obj/structure/barricade/bars{max_integrity = 800; name = "strong metal bars"; obj_integrity = 800},/obj/machinery/door/poddoor/shutters/old{id = "245"},/turf/open/floor/plasteel/f13/vault_floor/floor,/area/f13/vault)
"G" = (/obj/machinery/light{dir = 1},/turf/open/indestructible/ground/outside/desert,/area/f13/wasteland)
"M" = (/obj/structure/shelf_wood,/obj/machinery/light,/turf/open/floor/plasteel/f13/vault_floor/floor,/area/f13/vault)
"N" = (/turf/open/transparent/openspace,/area/f13/vault)
"S" = (/obj/machinery/door/poddoor/shutters/old{id = "245"},/obj/machinery/door/airlock/vault{req_one_access_txt = "126"},/turf/open/floor/plasteel/f13/vault_floor/floor,/area/f13/vault)
"U" = (/obj/item/radio/intercom{pixel_x = 32},/turf/open/floor/plasteel/f13/vault_floor/floor,/area/f13/vault)
"W" = (/turf/closed/indestructible/vaultdoor,/area/f13/vault)
"Z" = (/obj/structure/shelf_wood,/obj/item/disk/holodisk,/obj/item/disk/holodisk,/obj/item/disk/holodisk,/obj/item/disk/holodisk,/turf/open/floor/plasteel/f13/vault_floor/floor,/area/f13/vault)

(1,1,1) = {"
aaaaaaaaaaaaaaaaaaaa
aaaaaaaaaaaaaaaaaaaa
aaaaaaaaaaaaaaaaaaaa
aaaaaaaaaaaaaaaaaaaa
aaaaaaaaaaaaaaaaaaaa
aaaaaaaaaaaaaaaaaaaa
aawwwwrDccDccDaaaaaa
aaEEEEEFzvhvuCWWaaaa
aaEEEEEFmmmmmmNWaaaa
aaEEfEEFmsvZmmNWaaaa
aaEEEEEFmmmmUDWWaaaa
aaEEEEEFmvMvuDaaaaaa
aagggggDScDccDaaaaaa
aaaaaaaGaaaaaaaaaaaa
aaaaaaaaaaaaaaaaaaaa
aaaaaaaaaaaaaaaaaaaa
aaaaaaaaaaaaaaaaaaaa
aaaaaaaaaaaaaaaaaaaa
aaaaaaaaaaaaaaaaaaaa
aaaaaaaaaaaaaaaaaaaa
"}
