//MAP CONVERTED BY dmm2tgm.py THIS HEADER COMMENT PREVENTS RECONVERSION, DO NOT REMOVE
"a" = (
/turf/open/floor/engine,
/area/shuttle/bos_elevator_tipton)
"m" = (
/obj/structure/chair/f13foldupchair{
	dir = 4
	},
/obj/machinery/computer/shuttle/bos_tipton_elevator{
	dir = 4;
	pixel_x = -28
	},
/turf/open/floor/engine,
/area/shuttle/bos_elevator_tipton)
"n" = (
/obj/structure/chair/f13foldupchair{
	dir = 4
	},
/turf/open/floor/engine,
/area/shuttle/bos_elevator_tipton)
"K" = (
/obj/structure/chair/f13foldupchair{
	dir = 4
	},
/obj/docking_port/mobile/elevator{
	dwidth = 0;
	height = 3;
	id = "bos_elevator_tipton";
	name = "BOS Elevator";
	width = 3
	},
/turf/open/floor/engine,
/area/shuttle/bos_elevator_tipton)
"L" = (
/obj/structure/chair/f13foldupchair{
	dir = 8
	},
/obj/machinery/computer/shuttle/bos_tipton_elevator{
	dir = 8;
	pixel_x = 28
	},
/turf/open/floor/engine,
/area/shuttle/bos_elevator_tipton)
"Q" = (
/obj/structure/chair/f13foldupchair{
	dir = 8
	},
/turf/open/floor/engine,
/area/shuttle/bos_elevator_tipton)

(1,1,1) = {"
n
m
K
"}
(2,1,1) = {"
a
a
a
"}
(3,1,1) = {"
Q
L
Q
"}
