//MAP CONVERTED BY dmm2tgm.py THIS HEADER COMMENT PREVENTS RECONVERSION, DO NOT REMOVE
"a" = (
/obj/structure/chair/right{
	dir = 8
	},
/turf/open/floor/f13,
/area/shuttle)
"c" = (
/obj/structure/chair/right{
	dir = 4
	},
/turf/open/floor/f13,
/area/shuttle)
"f" = (
/obj/structure/barricade/train{
	dir = 5
	},
/turf/open/indestructible/ground/inside/subway,
/area/shuttle)
"i" = (
/obj/structure/table,
/obj/machinery/light{
	dir = 1
	},
/turf/open/floor/f13,
/area/shuttle)
"j" = (
/obj/structure/table,
/obj/machinery/light/broken{
	dir = 1
	},
/turf/open/floor/f13,
/area/shuttle)
"k" = (
/obj/structure/barricade/train{
	dir = 1
	},
/turf/open/indestructible/ground/inside/subway,
/area/shuttle)
"l" = (
/obj/structure/barricade/train{
	dir = 8
	},
/turf/open/floor/f13,
/area/shuttle)
"m" = (
/obj/structure/wreck/trash/machinepile,
/turf/open/floor/f13,
/area/shuttle)
"n" = (
/obj/machinery/door/airlock/public,
/turf/open/floor/f13,
/area/shuttle)
"q" = (
/obj/structure/barricade/train,
/turf/open/indestructible/ground/inside/subway,
/area/shuttle)
"s" = (
/obj/machinery/door/airlock/grunge,
/turf/open/floor/f13,
/area/shuttle)
"t" = (
/obj/structure/chair/comfy/shuttle{
	dir = 4;
	name = "driver's seat"
	},
/turf/open/floor/f13,
/area/shuttle)
"w" = (
/obj/structure/barricade/train{
	dir = 10
	},
/obj/docking_port/mobile/elevator{
	width = 38;
	height = 5;
	name = "raider train";
	id = "raider_train";
	dwidth = 1;
	can_move_docking_ports = 1
	},
/turf/open/indestructible/ground/inside/subway,
/area/shuttle)
"z" = (
/turf/open/indestructible/ground/inside/subway,
/area/shuttle)
"A" = (
/obj/structure/barricade/train{
	dir = 8
	},
/turf/open/indestructible/ground/inside/subway,
/area/shuttle)
"B" = (
/obj/structure/chair/left{
	dir = 8
	},
/turf/open/floor/f13,
/area/shuttle)
"E" = (
/obj/structure/barricade/train{
	dir = 9
	},
/turf/open/indestructible/ground/inside/subway,
/area/shuttle)
"F" = (
/obj/machinery/computer/shuttle/raidertrain{
	dir = 8
	},
/turf/open/floor/f13,
/area/shuttle)
"G" = (
/obj/structure/barricade/train{
	dir = 6
	},
/turf/open/indestructible/ground/inside/subway,
/area/shuttle)
"H" = (
/obj/structure/table,
/obj/machinery/light/broken,
/turf/open/floor/f13,
/area/shuttle)
"I" = (
/obj/structure/chair/left{
	dir = 4
	},
/turf/open/floor/f13,
/area/shuttle)
"K" = (
/turf/open/floor/f13,
/area/shuttle)
"O" = (
/obj/structure/barricade/train{
	dir = 4
	},
/turf/open/floor/f13,
/area/shuttle)
"T" = (
/obj/structure/fluff/rails,
/obj/structure/barricade/train{
	dir = 8
	},
/turf/open/indestructible/ground/inside/subway,
/area/shuttle)
"U" = (
/obj/machinery/door/airlock/grunge,
/turf/open/indestructible/ground/inside/subway,
/area/shuttle)
"V" = (
/obj/structure/window/fulltile/house{
	icon_state = "storewindowbottom";
	name = "train cabin"
	},
/turf/open/indestructible/ground/inside/subway,
/area/shuttle)
"W" = (
/obj/structure/window/fulltile/house{
	dir = 2;
	icon_state = "storewindowtop";
	name = "train cabin"
	},
/turf/open/indestructible/ground/inside/subway,
/area/shuttle)

(1,1,1) = {"
f
A
T
A
w
"}
(2,1,1) = {"
z
n
K
n
z
"}
(3,1,1) = {"
k
O
s
O
q
"}
(4,1,1) = {"
k
c
K
I
q
"}
(5,1,1) = {"
k
c
K
I
q
"}
(6,1,1) = {"
k
c
K
I
q
"}
(7,1,1) = {"
k
i
K
H
q
"}
(8,1,1) = {"
k
B
K
a
q
"}
(9,1,1) = {"
k
B
K
a
q
"}
(10,1,1) = {"
k
B
K
a
q
"}
(11,1,1) = {"
k
l
s
l
q
"}
(12,1,1) = {"
z
n
K
n
z
"}
(13,1,1) = {"
k
O
s
O
q
"}
(14,1,1) = {"
k
c
K
I
q
"}
(15,1,1) = {"
k
c
K
I
q
"}
(16,1,1) = {"
k
c
K
I
q
"}
(17,1,1) = {"
k
j
K
H
q
"}
(18,1,1) = {"
k
B
K
a
q
"}
(19,1,1) = {"
k
B
K
a
q
"}
(20,1,1) = {"
k
c
K
I
q
"}
(21,1,1) = {"
k
c
K
I
q
"}
(22,1,1) = {"
k
j
K
H
q
"}
(23,1,1) = {"
k
B
K
a
q
"}
(24,1,1) = {"
k
B
K
a
q
"}
(25,1,1) = {"
k
B
K
a
q
"}
(26,1,1) = {"
k
l
s
l
q
"}
(27,1,1) = {"
z
n
K
n
z
"}
(28,1,1) = {"
k
O
s
O
q
"}
(29,1,1) = {"
k
c
K
I
q
"}
(30,1,1) = {"
k
c
K
I
q
"}
(31,1,1) = {"
k
c
K
I
q
"}
(32,1,1) = {"
k
j
K
H
q
"}
(33,1,1) = {"
k
B
K
a
q
"}
(34,1,1) = {"
k
B
K
a
q
"}
(35,1,1) = {"
k
l
s
l
q
"}
(36,1,1) = {"
k
t
K
t
q
"}
(37,1,1) = {"
k
F
K
m
q
"}
(38,1,1) = {"
E
W
U
V
G
"}
