//MAP CONVERTED BY dmm2tgm.py THIS HEADER COMMENT PREVENTS RECONVERSION, DO NOT REMOVE
"a" = (
/obj/structure/barricade/train{
	dir = 10
	},
/turf/open/indestructible/ground/inside/subway,
/area/shuttle/junker_train)
"c" = (
/obj/structure/barricade/train{
	dir = 5
	},
/turf/open/indestructible/ground/inside/subway,
/area/shuttle/junker_train)
"d" = (
/obj/structure/barricade/train{
	dir = 9
	},
/turf/open/indestructible/ground/inside/subway,
/area/shuttle/junker_train)
"h" = (
/obj/structure/window/fulltile/house{
	icon_state = "storewindowbottom";
	name = "train cabin"
	},
/turf/open/floor/f13,
/area/shuttle/junker_train)
"i" = (
/obj/machinery/door/airlock/grunge,
/obj/docking_port/mobile/elevator{
	dir = 4;
	dwidth = 2;
	id = "raider_station_train"
	},
/turf/open/indestructible/ground/inside/subway,
/area/shuttle/junker_train)
"k" = (
/obj/structure/table/booth,
/turf/open/floor/f13,
/area/shuttle/junker_train)
"l" = (
/obj/structure/chair/booth{
	dir = 8
	},
/turf/open/floor/f13,
/area/shuttle/junker_train)
"t" = (
/obj/structure/barricade/train{
	dir = 1
	},
/turf/open/indestructible/ground/inside/subway,
/area/shuttle/junker_train)
"u" = (
/obj/structure/barricade/train{
	dir = 8
	},
/turf/open/floor/f13,
/area/shuttle/junker_train)
"A" = (
/obj/machinery/door/airlock/grunge,
/turf/open/indestructible/ground/inside/subway,
/area/shuttle/junker_train)
"F" = (
/turf/open/floor/f13,
/area/shuttle/junker_train)
"K" = (
/obj/structure/chair/comfy/shuttle{
	dir = 4;
	name = "driver's seat"
	},
/obj/machinery/light/small{
	dir = 8
	},
/turf/open/floor/f13,
/area/shuttle/junker_train)
"L" = (
/obj/machinery/computer/shuttle{
	dir = 8;
	name = "train controls";
	possible_destinations = "raider_train;raider_station"
	},
/turf/open/floor/f13,
/area/shuttle/junker_train)
"N" = (
/obj/structure/barricade/train,
/turf/open/indestructible/ground/inside/subway,
/area/shuttle/junker_train)
"P" = (
/obj/structure/window/fulltile/house{
	dir = 2;
	icon_state = "storewindowtop";
	name = "train cabin"
	},
/turf/open/floor/f13,
/area/shuttle/junker_train)
"S" = (
/obj/machinery/door/airlock/grunge,
/turf/open/floor/f13,
/area/shuttle/junker_train)
"T" = (
/obj/structure/barricade/train{
	dir = 6
	},
/turf/open/indestructible/ground/inside/subway,
/area/shuttle/junker_train)
"U" = (
/obj/structure/barricade/train{
	dir = 8
	},
/turf/open/indestructible/ground/inside/subway,
/area/shuttle/junker_train)
"Z" = (
/obj/structure/chair/booth{
	dir = 4
	},
/obj/machinery/light/small{
	dir = 8
	},
/turf/open/floor/f13,
/area/shuttle/junker_train)

(1,1,1) = {"
c
U
i
U
a
"}
(2,1,1) = {"
t
Z
F
Z
N
"}
(3,1,1) = {"
t
k
F
k
N
"}
(4,1,1) = {"
t
l
F
l
N
"}
(5,1,1) = {"
A
F
F
F
A
"}
(6,1,1) = {"
t
F
F
F
N
"}
(7,1,1) = {"
A
F
F
F
A
"}
(8,1,1) = {"
t
u
S
u
N
"}
(9,1,1) = {"
t
K
F
K
N
"}
(10,1,1) = {"
t
L
F
L
N
"}
(11,1,1) = {"
d
P
S
h
T
"}
